TestTwo
An Interactive Fiction by Ava Morgan
Release 1 / Serial number 250910 / Inform 7 v10.1.2 / D

bank
You walk along the silty dirt. Legends say a great evil destroyed this ecosystem by devouring all of the fish, and the ground itself trembles as you approach, yet, water laps calmly at the riverbank.

As you approach, you spy a long harpoon spiraling out from the river.

>examine ground
A long rope lays in the dusty dirt.

>take rope
Taken.

>take harpoon
you lasso the harpoon with the rope.

>examine riv3er
You can't see any such thing.

>x river
You can't see any such thing.

>see river
That's not a verb I recognise.

>go to river
You can't see any such thing.

>examine river
You can't see any such thing.

>examine River
You can't see any such thing.

* * *

TestTwo
An Interactive Fiction by Ava Morgan
Release 1 / Serial number 250910 / Inform 7 v10.1.2 / D

bank
You walk along the silty dirt. Legends say a great evil destroyed this ecosystem by devouring all of the fish, and the ground itself trembles as you approach, yet, water laps calmly at the riverbank.

As you approach, you spy a long harpoon spiraling out from the river.

>l river
You can't see any such thing.

>l
The river has turned rough and angry and cannot be entered.

>l
The river has turned rough and angry and cannot be entered.

>x river
You can't see any such thing.

>x
(Harpoon)
Rust grows around its edges. It's plunged deep into the center of the river, the remains of a fierce battle.

* * *

TestTwo
An Interactive Fiction by Ava Morgan
Release 1 / Serial number 250910 / Inform 7 v10.1.2 / D

bank
You walk along the silty dirt. Legends say a great evil destroyed this ecosystem by devouring all of the fish, and the ground itself trembles as you approach, yet, water laps calmly at the riverbank.

As you approach, you spy a long harpoon spiraling out from the river.

>take rope
You can't see any such thing.

>x ground
A long rope lays in the dusty dirt.

>take rope
Taken.

* * *

TestTwo
An Interactive Fiction by Ava Morgan
Release 1 / Serial number 250910 / Inform 7 v10.1.2 / D

bank
You walk along the silty dirt. Legends say a great evil destroyed this ecosystem by devouring all of the fish, and the ground itself trembles as you approach, yet, water laps calmly at the riverbank.

As you approach, you spy a long harpoon spiraling out from the river.

>x
(Harpoon)
Rust grows around its edges. It's plunged deep into the center of the river, the remains of a fierce battle.

>x ground
A long rope lays in the dusty dirt.

* * *

>take rope
Taken.

>take harpoon
you lasso the harpoon with the rope

* * *

TestTwo
An Interactive Fiction by Ava Morgan
Release 1 / Serial number 250910 / Inform 7 v10.1.2 / D

bank
You walk along the silty dirt. Legends say a great evil destroyed this ecosystem by devouring all of the fish, and the ground itself trembles as you approach, yet, water laps calmly at the riverbank.

As you approach, you spy a long harpoon spiraling out from the river.

>x ground
A long rope lays in the dusty dirt.

>l
River
You walk along the silty dirt. Legends say a great evil destroyed this ecosystem by devouring all of the fish, and the ground itself trembles as you approach, yet, water laps calmly at the riverbank.

As you approach, you spy a long harpoon spiraling out from the river.

You can also see rope here.

* * *

>x ground
A long rope lays in the dusty dirt.

>look at ground
You can't see any such thing.

* * *

>x ground
A long rope lays in the dusty dirt.

>x rope
You can't see any such thing.

* * *

TestTwo
An Interactive Fiction by Ava Morgan
Release 1 / Serial number 250910 / Inform 7 v10.1.2 / D

bank
You walk along the silty dirt. Legends say a great evil destroyed this ecosystem by devouring all of the fish, and the ground itself trembles as you approach, yet, water laps calmly at the riverbank.

As you approach, you spy a long harpoon spiraling out from the river.

>x harpoon
Rust grows around its edges. It's plunged deep into the center of the river, the remains of a fierce battle.

>x Harpoon
You can't see any such thing.

>examine harpoon
You can't see any such thing.

>look at harpoon
You can't see any such thing.

* * *

>x harpoon
Rust grows around its edges. It's plunged deep into the center of the river, the remains of a fierce battle.

>x ground
You can't see any such thing.

* * *

TestTwo
An Interactive Fiction by Ava Morgan
Release 1 / Serial number 250910 / Inform 7 v10.1.2 / D

bank
You walk along the silty dirt. Legends say a great evil destroyed this ecosystem by devouring all of the fish, and the ground itself trembles as you approach, yet, water laps calmly at the riverbank.

As you approach, you spy a long harpoon spiraling out from the river.

>x river
The river has turned rough and angry and cannot be entered.

>l river
You can't see any such thing.

>x ground
A long rope lays in the dusty dirt.

* * *

>x river
The river has turned rough and angry and cannot be entered.

>x River
You can't see any such thing.