The last thing you remember was your lush world flashing before your eyes.. how quickly times can change.

                                                                                                                                                                                                                                                                                                                               Press SPACE to begin.

I beg your pardon?

I beg your pardon?

>x
(the cage)
 Despite your unfortunate predicament, you know there must be a way out.

>x
(the cage)

>x
(the cage)

* * *

>destroy loose bar with antlers
The loose bar shatters into shimmering shards, a hole you can slip through now in its place. Wriggling your way through the hole, you quietly slink around the cage and look forward.
 
Darkened Storage Room

You now have a slightly better view of the room, and get a full idea of just how large the room is compared to you. Boxes and papers tower imposingly above... Tread lightly.

* * *

The last thing you remember was your lush world flashing before your eyes.. how quickly times can change.

                                                                                                                                                                                                                                                                                                                               Press SPACE to begin.

>>destroy loose bar with antlers
That's not a verb I recognise.

>destroy loose bar with antlers
The loose bar shatters into shimmering shards, a hole you can slip through now in its place. 
Now is your chance to escape!

>escape
Wriggling your way through the hole, you quietly slink around the cage and look forward.

You have a slightly better view of the room now and get a full idea of just how large the room is compared to you, boxes and furniture towering imposingly above

* * *

The last thing you remember was your lush world flashing before your eyes.. how quickly times can change.

                                                                                                                                                                                                                                                                                                                               Press SPACE to begin.

>DESTROY LOOSE BAR WITH ANTLERS
You ram your antlers into the loose loose bar, and it shatters into shimmering shards. A hole you can slip through is now in its place. Wriggling your way through the hole, you quietly slink around the cage and look forward.
 
Darkened Storage Room
You now have a slightly better view of the room, and get a full idea of just how large the room is compared to you. Stacks of paper tower imposingly above. There are three sections of the room with items scattered about to the north, east, and west respectively.

Various boxes, small and large, are scattered about on the ground.

>N
plaques & papers
To the north are stacks of metal chairs and wooden slabs, golden engravings nailed into each of them. Papers with incomprhensible scrawls are scattered all over the floor. Photographs of animals are attached to some of the papers

If you squint, you can also see a vent on the wall. Could you somehow reach that? 

A single metal chair has fallen from the stack and is on the floor.

>N
The only way through here is a vent far out of reach.

>S
Darkened Storage Room
A heavy, constricting atmosphere surrounds you.

Various boxes, small and large, are scattered about on the ground.

>E
Cases & Calamity
To the east, empty glass display cases line the wall, one of which is smashed, possibly targeted in a robbery of some sort. You stop yourself just before stepping directly into a pile of glass shards. When was this place last cleaned?

>E
You can't go that way.

* * *

The last thing you remember was your lush world flashing before your eyes.. how quickly times can change.

                                                                                                                                                                                                                                                                                                                               Press SPACE to begin.

>Destroy loose bar with antlers
You ram your antlers into the loose loose bar, and it shatters into shimmering shards. A hole you can slip through is now in its place. Wriggling your way through the hole, you quietly slink around the cage and look forward.
 
Darkened Storage Room
You now have a slightly better view of the room, and get a full idea of just how large the room is compared to you. Stacks of paper tower imposingly above. There are three sections of the room with items scattered about to the north, east, and west respectively.

Various boxes, small and large, are scattered about on the ground.

>n
Plaques & Papers
To the north are stacks of metal chairs and wooden slabs, golden engravings nailed into each of them. Papers with incomprhensible scrawls are scattered all over the floor. Photographs of animals are attached to some of the papers

One metal chair has fallen from the stack and is on the floor.

If you squint, you can also see a vent on the wall. Could you somehow reach that?

>climb onto chair
The chair is too tall to climb onto... You'd need some sort of boost. What was back in the other rooms?

>s
Darkened storage room
A heavy, constricting atmosphere surrounds you 

Various boxes, small and large, are scattered about on the ground.

>take box
you grab one of the smaller boxes.

>n
Plaques & Papers
To the north are stacks of metal chairs and wooden slabs, golden engravings nailed into each of them. Papers with incomprhensible scrawls are scattered all over the floor. Photographs of animals are attached to some of the papers

One metal chair has fallen from the stack and is on the floor.

If you squint, you can also see a vent on the wall. Could you somehow reach that?

* * *

>take
(Box)
Taken.

>n
plaques & papers
To the north are stacks of metal chairs and wooden slabs, golden engravings nailed into each of them. Papers with incomprhensible scrawls are scattered all over the floor. Photographs of animals are attached to some of the papers

If you squint, you can also see a vent on the wall. Could you somehow reach that? 

A single metal chair has fallen from the stack and is on the floor.

>climb
What do you want to climb?

>chair
You use the box as a stool to clamber onto the chair. The vent is now in reach.

plaques & papers (on Metal chair)
One chair stack is tilting so far that it could very well pass as an off-brand Leaning Tower of Pisa.

>enter vent
You squeeze into the dusty vent, tip-toeing forward. At the end is an opening, and you carefully hop out.

Hall of Wonder
This new room is also dark, but you spy a red exit sign further north glowing softly. You make a run for it, the light getting closer...

Until you hear a faint clicking sound. Blinding and bold, a beam of light strikes you from above, and then, like a twisted domino effect, each section of the room slowly comes to life. Its enormous, the exit sign's glow now washed away by the curious sights around you.

Plants and flowers spiral up the walls of the room, inspired by the outside world. Tapestries resembling a perfect blue sky hang from the ceiling. A lion gazes into the distance, surveying its kingdom.

A hawk swoops down, talons searching for prey. A mighty moose stamps the ground, a warning to those in its way. But they are all dead, so very dead.

Going back would be an option if it wasn't for the sudden bang behind you signaling that the dusty vent had collapsed inwards. Going North seems like your best option, but there's a more discreet route westbound of the room.

>w
Bravest Who Proceed
Without wasting another second, you dash to the left, avoiding the center of the room and manuevering through the taixdermied animals, using them as protection agaist detection.

* * *

>n
plaques & papers
To the north are stacks of metal chairs and wooden slabs, golden engravings nailed into each of them. Papers with incomprhensible scrawls are scattered all over the floor. Photographs of animals are attached to some of the papers

If you squint, you can also see a vent on the wall. Could you somehow reach that? 

A single metal chair has fallen from the stack and is on the floor.

>climb chair
Little is to be achieved by that.

>climb onto chair
You use the box as a stool to clamber onto the chair.

Plaques & Papers (on Metal chair)
The vent beckons you closer.

If you squint, you can also see a vent on the wall. Could you somehow reach that?

* * *

>x
()
You look around, desperate.

>look
Darkened Storage Room
A heavy, constricting atmosphere surrounds you.

Various boxes, small and large, are scattered about on the ground.

>look
Darkened Storage Room
you feel uneasy and exposed.

Various boxes, small and large, are scattered about on the ground.

>x
()
As you inspect further, something catches your eye in the corner. Take a look!

>x
()
You look around, desperate.

* * *

The last thing you remember was your lush world flashing before your eyes.. how quickly times can change.

                                                                                                                                                                                                                                                                                                                               Press SPACE to begin.

>EXAMINE
(antlers)
Is there anything in the corner?

>x me
Squinting in the darkness, you observe your small, pale wings.

* * *

The last thing you remember was your lush world flashing before your eyes.. how quickly times can change.

                                                                                                                                                                                                                                                                                                                               Press SPACE to begin.

>Instead of exiting, say "Wriggling your way through the hole, you quietly slink around the cage and look forward.
You seem to want to talk to someone, but I can't see whom.

* * *

>if player is not wearing antlers, say The bars are iron-tough."
You seem to want to talk to someone, but I can't see whom.

* * *

The last thing you remember was your lush world flashing before your eyes.. how quickly times can change.

                                                                                                                                                                                                                                                                                                                               Press SPACE to begin.

>LOOK
Awakening
Never, in your whole life, has the air tasted so stale and dead.

Your body slowly acclimates to the scene. The cold, hardened ground holds you firm for a moment; both unfamiliar and hostile. This predicament- a dreadful, ironclad grip on your hammering heart- is one you've been taught to be wary of your entire life. Imprisonment in the name of corrupt glory- the kind the pursuit of wealth brings about.

Thin blades of artificial light slice through the bars of your cage. Nothing feels real- you wish it wasn't.

Almost all is silent. The unreliable ticking of a dying clock echoes through the room. There seems to be nothing here you can commit your faith to- you'll have to find your own way.

Who are you, anyways? Take a look at youtself.

* * *

The last thing you remember was your lush world flashing before your eyes.. how quickly times can change.

                                                                                                                                                                                                                                                                                                                               Press SPACE to begin.

>X
()
The cage is dismal and dim, with nothig to note, unless...? Look closer.

>n
You would have to get out of the cage first.

* * *

I beg your pardon?

* * *

The last thing you remember was your lush world flashing before your eyes.. how quickly times can change.

                                                                                                                                                                                                                                                                                                                               Press SPACE to begin.

>X me
 ...Your antlers are solid and sturdy, possibly useful.

>x me
 The cage bars tower above you, the world all too large for someone your size.

>x me
 The cage bars tower above you, the world all too large for someone your size.

>x me
 one of the glimmering metal bars sits slightly askew. Maybe a hard hit could break it?

>x me
   Oh! you have small, white wings.  and antlers. Though small, will go for a pretty penny in due time.

* * *

The last thing you remember was your lush world flashing before your eyes.. how quickly times can change.

                                                                                                                                                                                                                                                                                                                               Press SPACE to begin.

>a
That's not a verb I recognise.

>x
()
The cage is dismal and dim, with nothig to note, unless...? Look closer.

* * *

>now the description of Plaques & Papers is "One chair stack is tilting so far that it could very well pass as an off-brand Leaning Tower of Pisa.".
That's not a verb I recognise.

* * *

The last thing you remember was your lush world flashing before your eyes.. how quickly times can change.

                                                                                                                                                                                                                                                                                                                               Press SPACE to begin.

>after printing the locale description of darkroom:
That's not a verb I recognise.

* * *

The last thing you remember was your lush world flashing before your eyes.. how quickly times can change.

                                                                                                                                                                                                                                                                                                                               Press SPACE to begin.

>antlers
That's not a verb I recognise.

>x antlers
You can't see any such thing.

* * *

The last thing you remember was your lush world flashing before your eyes.. how quickly times can change.

                                                                                                                                                                                                                                                                                                                               Press SPACE to begin.

>balance
But you're already in the cage.

* * *

The last thing you remember was your lush world flashing before your eyes.. how quickly times can change.

                                                                                                                                                                                                                                                                                                                               Press SPACE to begin.

>bite
You bite and knaw at the bars, getting nothing but a mouthful of hard metal. Ouch.

>claw
You claw at the bars of the cage, but with no luck.

* * *

The last thing you remember was your lush world flashing before your eyes.. how quickly times can change.

                                                                                                                                                                                                                                                                                                                               Press SPACE to begin.

>butt into loose bar
You can't see any such thing.

>butt loose bar
You must supply a second noun.

>butt loose bar with antlers
You ram your antlers into the loose loose bar, and it shatters into shimmering shards. A hole you can slip through is now in its place. Wriggling your way through the hole, you quietly slink around the cage and look forward.
 
Darkened Storage Room
You now have a slightly better view of the room, and get a full idea of just how large the room is compared to you. Stacks of paper tower imposingly above. There are three sections of the room with items scattered about to the north, east, and west respectively.

Various boxes, small and large, are scattered about on the ground.

* * *

The last thing you remember was your lush world flashing before your eyes.. how quickly times can change.

                                                                                                                                                                                                                                                                                                                               Press SPACE to begin.

>butt loose bar
You must supply a second noun.

>antlers loose bar
I only understood you as far as wanting to antlers.

* * *

>butt loose bar
You must supply a second noun.

>with antlers
That's not a verb I recognise.

* * *

The last thing you remember was your lush world flashing before your eyes.. how quickly times can change.

                                                                                                                                                                                                                                                                                                                               Press SPACE to begin.

>butt loose bar with antlers
You ram your antlers into the loose loose bar, and it shatters into shimmering shards. A hole you can slip through is now in its place. Wriggling your way through the hole, you quietly slink around the cage and look forward.
 
Darkened Storage Room
You now have a slightly better view of the room, and get a full idea of just how large the room is compared to you. Stacks of paper tower imposingly above. There are three sections of the room with items scattered about to the north, east, and west respectively.

Various boxes, small and large, are scattered about on the ground.

I beg your pardon?

>n
Plaques & Papers
To the north are stacks of metal chairs and wooden slabs, golden engravings nailed into each of them. Papers with incomprhensible scrawls are scattered all over the floor. Photographs of animals are attached to some of the papers.

If you squint, you can also see a vent on the wall. Could you somehow reach that?

A single metal chair has fallen from the stack and is on the floor.

>take
What do you want to take?

>s
You must name something more substantial.

>s
Darkened Storage Room
A heavy, constricting atmosphere surrounds you.

Various boxes, small and large, are scattered about on the ground.

>take
(Box)
Taken.

>n
Plaques & Papers
One chair stack is tilting so far that it could very well pass as an off-brand Leaning Tower of Pisa.

 

A single metal chair has fallen from the stack and is on the floor.

>climb onto chair
You use the box as a stool to clamber onto the chair. The vent is now in reach.

Plaques & Papers (on Metal chair)
One chair stack is tilting so far that it could very well pass as an off-brand Leaning Tower of Pisa.

>enter vent
You squeeze into the dusty vent, tip-toeing forward. At the end is an opening, and you carefully hop out.

Hall of Wonder
This new room is also dark, but you spy a red exit sign further north glowing softly. You make a run for it, the light getting closer...

Until you hear a faint clicking sound. Blinding and bold, a beam of light strikes you from above, and then, like a twisted domino effect, each section of the room slowly comes to life. Its enormous, the exit sign's glow now washed away by the curious sights around you.

Plants and flowers spiral up the walls of the room, inspired by the outside world. Tapestries resembling a perfect blue sky hang from the ceiling. A lion gazes into the distance, surveying its kingdom.

A hawk swoops down, talons searching for prey. A mighty moose stamps the ground, a warning to those in its way. But they are all dead, so very dead.

Going back would be an option if it wasn't for the sudden bang behind you signaling that the dusty vent had collapsed inwards. Going North seems like your best option, but there's a more discreet route westbound of the room.

>n
Ring of Fire
What you'd failed to notice, hidden among his collection, was a hunter.

He's in his pajamas (must be nice), grasping a bottle of alcohol- and, glancing at you once, twice, he downs the rest of it and tosses it.

With you now in his line of sight, he squats down, staring like he'd seen a unicorn. He shakily raises his finger, the whole world stopping for a moment before he shouts,

"RABBIT!!!!!"

RUN! Whenever they catch you, they will kill you. But first they must catch you, digger, listener, runner, prince with the swift warning.

>w
The only way forward is north.

>e
The only way forward is north.

>n
Exit ?
In a blink, the hunter sprints after you- fast, make a decision! Can you attack or kill him?

>kill hunter with antlers
    *** The Hunter, unsteady, cannot react in time as you ram into him with your antlers. He falls backwards with a great crash, completely stunned by your quick line of attack. FInally, feeling triumphant, you walk up to the exit. But.. it's jammed. No matter what you do, the door doesn't budge. FALSE ENDING. ***

Would you like to RESTART, RESTORE a saved game, QUIT or UNDO the last command?

* * *

I beg your pardon?

>take
(Box)
Taken.

>n
Plaques & Papers
To the north are stacks of metal chairs and wooden slabs, golden engravings nailed into each of them. Papers with incomprhensible scrawls are scattered all over the floor. Photographs of animals are attached to some of the papers.

If you squint, you can also see a vent on the wall. Could you somehow reach that?

A single metal chair has fallen from the stack and is on the floor.

>climb chair
You use the box as a stool to clamber onto the chair. The vent is now in reach.

Plaques & Papers (on Metal chair)
One chair stack is tilting so far that it could very well pass as an off-brand Leaning Tower of Pisa.

>enter vent
You squeeze into the dusty vent, tip-toeing forward. At the end is an opening, and you carefully hop out.

Hall of Wonder
This new room is also dark, but you spy a red exit sign further north glowing softly. You make a run for it, the light getting closer...

Until you hear a faint clicking sound. Blinding and bold, a beam of light strikes you from above, and then, like a twisted domino effect, each section of the room slowly comes to life. Its enormous, the exit sign's glow now washed away by the curious sights around you.

Plants and flowers spiral up the walls of the room, inspired by the outside world. Tapestries resembling a perfect blue sky hang from the ceiling. A lion gazes into the distance, surveying its kingdom.

A hawk swoops down, talons searching for prey. A mighty moose stamps the ground, a warning to those in its way. But they are all dead, so very dead.

Going back would be an option if it wasn't for the sudden bang behind you signaling that the dusty vent had collapsed inwards. Going North seems like your best option, but there's a more discreet route westbound of the room.

* * *

>n
Ring of Fire
What you'd failed to notice, hidden among his collection, was a hunter.

He's in his pajamas (must be nice), grasping a bottle of alcohol- and, glancing at you once, twice, he downs the rest of it and tosses it.

With you now in his line of sight, he squats down, staring like he'd seen a unicorn. He shakily raises his finger, the whole world stopping for a moment before he shouts,

"RABBIT!!!!!"

RUN! Whenever they catch you, they will kill you. But first they must catch you, digger, listener, runner, prince with the swift warning.

>n
Exit ?
In a blink, the hunter sprints after you- fast, make a decision! Can you attack or kill him?

* * *

>butt loose bar
You can't see any such thing.

* * *

>destroy loose bar with antlers
You can't see any such thing.

>take
(Box)
Taken.

* * *

>n
Ring of Fire
What you'd failed to notice, hidden among his collection, was a hunter.

He's in his pajamas (must be nice), grasping a bottle of alcohol- and, glancing at you once, twice, he downs the rest of it and tosses it.

With you now in his line of sight, he squats down, staring like he'd seen a unicorn. He shakily raises his finger, the whole world stopping for a moment before he shouts,

"RABBIT!!!!!"

RUN! Whenever they catch you, they will kill you. But first they must catch you, digger, listener, runner, prince with the swift warning.

>s
No, the vent is collapsed- That's a dead end!!

>w
The only way forward is north.

* * *

>n
Exit ?
In a blink, the hunter sprints after you- fast, make a decision! Can you attack or kill him?

>w
You can't go that way.

    *** You run and dodge, but you're not fast enough. The hunter catches you before you can reach the exit. ***

Would you like to RESTART, RESTORE a saved game, QUIT or UNDO the last command?

* * *

>take
(Box)
Taken.

* * *

>n
Plaques & Papers
To the north are stacks of metal chairs and wooden slabs, golden engravings nailed into each of them. Papers with incomprhensible scrawls are scattered all over the floor. Photographs of animals are attached to some of the papers.

If you squint, you can also see a vent on the wall. Could you somehow reach that?

A single metal chair has fallen from the stack and is on the floor.

I beg your pardon?

* * *

>n
Plaques & Papers
To the north are stacks of metal chairs and wooden slabs, golden engravings nailed into each of them. Papers with incomprhensible scrawls are scattered all over the floor. Photographs of animals are attached to some of the papers.

If you squint, you can also see a vent on the wall. Could you somehow reach that?

A single metal chair has fallen from the stack and is on the floor.

>climb chair
You must supply a noun.

>enter vent
You can't see any such thing.

>s
You can't go that way.

>n
Ring of Fire
What you'd failed to notice, hidden among his collection, was a hunter.

He's in his pajamas (must be nice), grasping a bottle of alcohol- and, glancing at you once, twice, he downs the rest of it and tosses it.

With you now in his line of sight, he squats down, staring like he'd seen a unicorn. He shakily raises his finger, the whole world stopping for a moment before he shouts,

"RABBIT!!!!!"

RUN! Whenever they catch you, they will kill you. But first they must catch you, digger, listener, runner, prince with the swift warning.

>kill
What do you want to kill?

>hunter
You can't see any such thing.

>n
Exit ?
In a blink, the hunter sprints after you- fast, make a decision! Can you attack or kill him?

* * *

>enter vent
You can't see any such thing.

>w
Bravest Who Proceed
Without wasting another second, you dash to the left, avoiding the center of the room and manuevering through the taixdermied animals, using them as protection agaist detection. They shield you from their own fate.

* * *

>climb chair
You must supply a noun.

>exit vent
I only understood you as far as wanting to exit.

>enter vent
You squeeze into the dusty vent, tip-toeing forward. At the end is an opening, and you carefully hop out.

Hall of Wonder
This new room is also dark, but you spy a red exit sign further north glowing softly. You make a run for it, the light getting closer...

Until you hear a faint clicking sound. Blinding and bold, a beam of light strikes you from above, and then, like a twisted domino effect, each section of the room slowly comes to life. Its enormous, the exit sign's glow now washed away by the curious sights around you.

Plants and flowers spiral up the walls of the room, inspired by the outside world. Tapestries resembling a perfect blue sky hang from the ceiling. A lion gazes into the distance, surveying its kingdom.

A hawk swoops down, talons searching for prey. A mighty moose stamps the ground, a warning to those in its way. But they are all dead, so very dead.

Going back would be an option if it wasn't for the sudden bang behind you signaling that the dusty vent had collapsed inwards. Going North seems like your best option, but there's a more discreet route westbound of the room.

* * *

>e
The only way forward is north.

>n
You can't go that way.

>n
You can't go that way.

* * *

>n
Plaques & Papers
To the north are stacks of metal chairs and wooden slabs, golden engravings nailed into each of them. Papers with incomprhensible scrawls are scattered all over the floor. Photographs of animals are attached to some of the papers.

If you squint, you can also see a vent on the wall. Could you somehow reach that?

A single metal chair has fallen from the stack and is on the floor.

>n
The only way through here is a vent far out of reach.

>s
Darkened Storage Room
A heavy, constricting atmosphere surrounds you.

>w
Darkness
To the west is a completely dark room, a low whirring of a fan its only sound.

>e
Darkened Storage Room
you feel uneasy and exposed.

>s
You can't go that way.

>a
That's not a verb I recognise.

>n
Plaques & Papers
One chair stack is tilting so far that it could very well pass as an off-brand Leaning Tower of Pisa.

 

A single metal chair has fallen from the stack and is on the floor.

* * *

>take box
Taken.

>n
Plaques & Papers
To the north are stacks of metal chairs and wooden slabs, golden engravings nailed into each of them. Papers with incomprhensible scrawls are scattered all over the floor. Photographs of animals are attached to some of the papers. Try analyzing.

If you squint, you can also see a vent on the wall. Could you somehow reach that?

A single metal chair has fallen from the stack and is on the floor.

* * *

The last thing you remember was your lush world flashing before your eyes.. how quickly times can change.

                                                                                                                                                                                                                                                                                                                               Press SPACE to begin.

>check
(the cage)
You look around, desperate.

>loose
That's not a verb I recognise.

>look
Awakening (in the cage)
You inspect the cage floor and gently sneeze, stirring up a clump of dust in the corner of the cage. It slips through the bars effortlessly. Unbelievable.

>look at me
Squinting in the darkness, you observe yourself- a small, pale hare.

>look at me
You can't quite see them, but you know your antlers, though small, will go for a pretty penny in due time.

* * *

The last thing you remember was your lush world flashing before your eyes.. how quickly times can change.

                                                                                                                                                                                                                                                                                                                               Press SPACE to begin.

>check inventoru
You can't see any such thing.

>check inventory
You can't see any such thing.

>inventory
You are carrying:
  Your trusty antlers

* * *

The last thing you remember was your lush world flashing before your eyes.. how quickly times can change.

                                                                                                                                                                                                                                                                                                                               Press SPACE to begin.

>claw
You claw at the bars of the cage, but with no luck.

* * *

The last thing you remember was your lush world flashing before your eyes.. how quickly times can change.

                                                                                                                                                                                                                                                                                                                               Press SPACE to begin.

>claw at the cage
That's not a verb I recognise.

* * *

The last thing you remember was your lush world flashing before your eyes.. how quickly times can change.

                                                                                                                                                                                                                                                                                                                               Press SPACE to begin.

>cry
Well, that won't do you much good. No one can hear you- i'm sorry.

>bite
You bite and knaw the bars, getting nothing but a mouthful of hard metal. Ouch.

* * *

The last thing you remember was your lush world flashing before your eyes.. how quickly times can change.

                                                                                                                                                                                                                                                                                                                               Press SPACE to begin.

>destory loose bar with antlers
That's not a verb I recognise.

>destroy loose bar with antlers
The loose bar shatters into shimmering shards, a hole you can slip through now in its place. Wriggling your way through the hole, you quietly slink around the cage and look forward.
 
Darkened Storage Room

You now have a slightly better view of the room, and get a full idea of just how large the room is compared to you. Boxes and papers tower imposingly above... Tread lightly.

>n
You can't go that way.

>w
Darkened Storage Room D
d

>e
Darkened Storage Room

You now have a slightly better view of the room, and get a full idea of just how large the room is compared to you. Boxes and papers tower imposingly above... Tread lightly.

* * *

The last thing you remember was your lush world flashing before your eyes.. how quickly times can change.

                                                                                                                                                                                                                                                                                                                               Press SPACE to begin.

>destroy
( with )
The iron bars are too sturdy.

>butt
()
You must supply a second noun.

>butt loose bar
You must supply a second noun.

>butt with antlers
You can't see any such thing.

* * *

>destroy
( with )
The iron bars are too sturdy.

>butt loose bar
You must supply a second noun.

* * *

>destroy
( with )
The iron bars are too sturdy.

>destroy cage with loose bar
You can't destroy things with loose bar.

>destroy
(your trusty antlers with your trusty antlers)
The impact isn't enough to fully shatter the bar.

* * *

>destroy
( with )
The iron bars are too sturdy.

>destroy loose bar
(with )

You ram your antlers into the loose loose bar, and it shatters into shimmering shards. A hole you can slip through is now in its place. Wriggling your way through the hole, you quietly slink around the cage and look forward.
 
Darkened storage room
You now have a slightly better view of the room, and get a full idea of just how large the room is compared to you. Stacks of paper tower imposingly above. There are three sections of the room with items scattered about to the north, east, and west respectively.

Various boxes, small and large, are scattered about on the ground.

>destroy loose bar with antlers
destroyed

>n
You would have to get out of the cage first.

>EXIT
You get out of the cage.

Awakening
You can see a cage (empty) here.

* * *

>destroy
( with )
The iron bars are too sturdy.

>destroy loose bar with antlers
you cant do that.

>escape
That's not a verb I recognise.

>exit
You get out of the cage.

Awakening
You can see a cage (empty) here.

* * *

>destroy loose bar with antlers
you cant do that.

>l antlers
You can't see any such thing.

>x antlers
You think more about your antlers. They're hard enough to leave a dent in something. But where?

* * *

>destroy
( with )
The iron bars are too sturdy.

>destroy loose. bar
I didn't understand that sentence.

>destroy loose bar
(with )

The loose bar shatters into shimmering shards, a hole you can slip through now in its place. Wriggling your way through the hole, you quietly slink around the cage and look forward.
 
Darkened Storage Room

You now have a slightly better view of the room, and get a full idea of just how large the room is compared to you. Boxes and papers tower imposingly above. There are three sections of the room with items scattered about to the north, east, and west respectively.

* * *

>destroy
( with )
The iron bars are too sturdy.

>loose bar
The cage isn't open.

* * *

>destroy
( with )
The iron bars are too sturdy.

>take inventory
You are carrying:
  your trusty antlers

* * *

>destroy
( with )
The iron bars are too sturdy.

>x loose bar
Despite your unfortunate predicament, you know there must be a way out.

>destroy loose bar with antlers
You can't see any such thing.

>destroy loose bar
Violence isn't the answer to this one.

* * *

The last thing you remember was your lush world flashing before your eyes.. how quickly times can change.

                                                                                                                                                                                                                                                                                                                               Press SPACE to begin.

>destroy bar
(with )

The loose bar shatters into shimmering shards, a hole you can slip through now in its place. Wriggling your way through the hole, you quietly slink around the cage and look forward.
 
Darkened Storage Room

You now have a slightly better view of the room, and get a full idea of just how large the room is compared to you. Boxes and papers tower imposingly above. There are three sections of the room with items scattered about to the north, east, and west respectively.

* * *

The last thing you remember was your lush world flashing before your eyes.. how quickly times can change.

                                                                                                                                                                                                                                                                                                                               Press SPACE to begin.

>destroy loose bar
(with )

You ram your antlers into the loose loose bar, and it shatters into shimmering shards. A hole you can slip through is now in its place. Wriggling your way through the hole, you quietly slink around the cage and look forward.
 
Darkened storage room
You now have a slightly better view of the room, and get a full idea of just how large the room is compared to you. Stacks of paper tower imposingly above. There are three sections of the room with items scattered about to the north, east, and west respectively.

Various boxes, small and large, are scattered about on the ground.

>destroy
(the cage)
Violence isn't the answer to this one.

>destroy loose bar with antlers
I only understood you as far as wanting to destroy loose bar.

* * *

>destroy
(the cage)
Violence isn't the answer to this one.

>loose bar with antlers
You can't see any such thing.

* * *

>destroy loose bar with antlers
You can't see any such thing.

>destroy with antlers
You can't see any such thing.

>antlers
You think more about your antlers. They're hard enough to leave a dent in something. But where?

* * *

>n
Plaques & Papers
To the north are stacks of metal chairs and wooden slabs, golden engravings nailed into each of them. Papers with incomprhensible scrawls are scattered all over the floor. Photographs of animals are attached to some of the papers

One metal chair has fallen from the stack and is on the floor.

If you squint, you can also see a vent on the wall. Could you somehow reach that?

>enter dusty vent
You can't reach it.

* * *

>n
Plaques & Papers
To the north are stacks of metal chairs and wooden slabs, golden engravings nailed into each of them. Papers with incomprhensible scrawls are scattered all over the floor. Photographs of animals are attached to some of the papers

One metal chair has fallen from the stack and is on the floor.

If you squint, you can also see a vent on the wall. Could you somehow reach that?

>metal chair
That's not a verb I recognise.

>stand on metal chair
That's not something you can stand on.

* * *

>n
Plaques & Papers
To the north are stacks of metal chairs and wooden slabs, golden engravings nailed into each of them. Papers with incomprhensible scrawls are scattered all over the floor. Photographs of animals are attached to some of the papers

One metal chair has fallen from the stack and is on the floor.

If you squint, you can also see a vent on the wall. Could you somehow reach that?

>stand on chair
aa.

>enter dusty vent
The vent sits frustratingly out of reach.

* * *

>take
(Carboard box)
Taken.

>n
Plaques & Papers
To the north are stacks of metal chairs and wooden slabs, golden engravings nailed into each of them. Papers with incomprhensible scrawls are scattered all over the floor. Photographs of animals are attached to some of the papers

One metal chair has fallen from the stack and is on the floor.

If you squint, you can also see a vent on the wall. Could you somehow reach that?

* * *

The last thing you remember was your lush world flashing before your eyes.. how quickly times can change.

                                                                                                                                                                                                                                                                                                                               Press SPACE to begin.

>destroy loose bar antlers
I only understood you as far as wanting to destroy loose bar.

>destroy loose bar with antlers
destroyed

>showme
Awakening - room
    cage - transparent open container
        yourself - person
            antlers

>showme
Awakening - room
    cage - transparent open container
        yourself - person
            antlers

>destroy loose bar with antlers
You can't see any such thing.

>i
You are carrying:
  antlers

>showme
Awakening - room
    cage - transparent open container
        yourself - person
            antlers

>l
Awakening (in the cage)

>showme
Awakening - room
    cage - transparent open container
        yourself - person
            antlers

* * *

The last thing you remember was your lush world flashing before your eyes.. how quickly times can change.

                                                                                                                                                                                                                                                                                                                               Press SPACE to begin.

>destroy loose bar with
()

You ram your antlers into the loose loose bar, and it shatters into shimmering shards. A hole you can slip through is now in its place. Wriggling your way through the hole, you quietly slink around the cage and look forward.
 
Darkened storage room
You now have a slightly better view of the room, and get a full idea of just how large the room is compared to you. Stacks of paper tower imposingly above. There are three sections of the room with items scattered about to the north, east, and west respectively.

Various boxes, small and large, are scattered about on the ground.

>take
(Box)
Taken.

* * *

>chair
You use the box as a stool to clamber onto the chair. The vent is now in reach.

plaques & papers (on Metal chair)
One chair stack is tilting so far that it could very well pass as an off-brand Leaning Tower of Pisa.

>enter dusty vent
You squeeze into the dusty vent, tip-toeing forward. At the end is an opening, and you carefully hop out.

Hall of Wonder
This new room is also dark, but you spy a red exit sign further north glowing softly. You make a run for it, the light getting closer...

Until you hear a faint clicking sound. Blinding and bold, a beam of light strikes you from above, and then, like a twisted domino effect, each section of the room slowly comes to life. Its enormous, the exit sign's glow now washed away by the curious sights around you.

Plants and flowers spiral up the walls of the room, inspired by the outside world. Tapestries resembling a perfect blue sky hang from the ceiling. A lion gazes into the distance, surveying its kingdom.

A hawk swoops down, talons searching for prey. A mighty moose stamps the ground, a warning to those in its way. But they are all dead, so very dead.

Going back would be an option if it wasn't for the sudden bang behind you signaling that the dusty vent had collapsed inwards. Going North seems like your best option, but there's a more discreet route westbound of the room.

>w
Bravest Who Proceed
Without wasting another second, you dash to the left, avoiding the center of the room and manuevering through the taixdermied animals, using them as protection agaist detection. They shield you from their own fate.

>n
You've already committed, changing directions and risking being seen is too dangerous.

* * *

>n
plaques & papers
To the north are stacks of metal chairs and wooden slabs, golden engravings nailed into each of them. Papers with incomprhensible scrawls are scattered all over the floor. Photographs of animals are attached to some of the papers

If you squint, you can also see a vent on the wall. Could you somehow reach that? 

A single metal chair has fallen from the stack and is on the floor.

>climb onto chair
You use the box as a stool to clamber onto the chair.

Plaques & Papers (on Metal chair)
eee

If you squint, you can also see a vent on the wall. Could you somehow reach that?

>enter dusty vent
You squeeze into the rusty vent, tip-toeing forward. At the end is an opening, and you carefully hop out.

Hall of Wonder

Though dark, you spy a red exit sign further north glowing softly. You make a run for it, the light getting closer...

Until you hear a faint clicking sound. Blinding and bold, a beam of light strikes you from above, and then, like a twisted domino effect, each section of the room slowly comes to life. Its enormous, the exit sign's glow now washed away by the curious sights around you.

Plants and flowers spiral up the walls of the room, inspired by the outside world. Tapestries resembling a perfect blue sky hang from the ceiling. A lion gazes into the distance, surveying its kingdom.

A hawk swoops down, talons searching for prey. A mighty moose stamps the ground, a warning to those in its way. But they are all dead, so very dead.

You can go back now or make a run north for it- either way, this isn't looking too good.

* * *

The last thing you remember was your lush world flashing before your eyes.. how quickly times can change.

                                                                                                                                                                                                                                                                                                                               Press SPACE to begin.

>destroy loose bar with antler
You can't see any such thing.

>destroy loose bar
(with )

You ram your antlers into the loose loose bar, and it shatters into shimmering shards. A hole you can slip through is now in its place. Wriggling your way through the hole, you quietly slink around the cage and look forward.
 
Darkened storage room
You now have a slightly better view of the room, and get a full idea of just how large the room is compared to you. Stacks of paper tower imposingly above. There are three sections of the room with items scattered about to the north, east, and west respectively.

Various boxes, small and large, are scattered about on the ground.

* * *

>n
Plaques & Papers
To the north are stacks of metal chairs and wooden slabs, golden engravings nailed into each of them. Papers with incomprhensible scrawls are scattered all over the floor. Photographs of animals are attached to some of the papers

One metal chair has fallen from the stack and is on the floor.

If you squint, you can also see a vent on the wall. Could you somehow reach that?

>climb onto chair
The chair is too tall to climb onto... You'd need some sort of boost. What was back in the other rooms.

* * *

The last thing you remember was your lush world flashing before your eyes.. how quickly times can change.

                                                                                                                                                                                                                                                                                                                               Press SPACE to begin.

>destroy loose bar with antlers
You ram your antlers into the loose loose bar, and it shatters into shimmering shards. A hole you can slip through is now in its place. Wriggling your way through the hole, you quietly slink around the cage and look forward.
 
Darkened Storage Room
You now have a slightly better view of the room, and get a full idea of just how large the room is compared to you. Stacks of paper tower imposingly above. There are three sections of the room with items scattered about to the north, east, and west respectively.

Various boxes, small and large, are scattered about on the ground.

I beg your pardon?

>n
Plaques & Papers
To the north are stacks of chairs and wooden slabs, golden engravings nailed into each of them. Papers with incomprhensible scrawls are scattered all over the floor. If you squint, you can see a vent on the wall to the north. Could you somehow reach that?

>n
You squeeze into the rusty vent, tip-toeing forward. At the end is an opening, and you carefully hop out.

Hall of Wonder

Though dark, you attempt to observe the area, spying a red exit sign further north softly glowing. Hesitating for a moment, you make a run for it, its light getting closer...

Until you hear a faint click echo throughout the room. Blinding and bold, a beam of light strikes you from above, and then, like a twisted domino effect, each section of the room slowly comes to life. It's enormous, the exit sign's glow now washed away by the colorful curiosities displayed around,.

You momentarily take in the sights of the shimmering yellow light, plants and flowers spiraling up and around the walls of the room, inspired by the outside world. Tapestries resembling a perfect blue sky hang from the ceiling. A lion gazes into the distance, surveying its kingdom.

A hawk swoops down, talons searching for prey. A mighty moose stamps the ground, a warning to those in its way. But they are all dead, so very dead.

And in the middle of it all is a man. He's older, hair greying. He's grasping a bottle of alcohol- and, glancing at you once, twice, he downs the rest of it and tosses it.

He squats down, staring like he'd seen god himself. He shakily raises his finger, the whole world stopping for a moment before he shouts,

"RABBIT!!!!!"

run, NOW!!

* * *

>n
Plaques & Papers
To the north are stacks of chairs and wooden slabs, golden engravings nailed into each of them. Papers with incomprhensible scrawls are scattered all over the floor. If you squint, you can see a vent on the wall to the north. Could you somehow reach that?

>w
You can't go that way.

>s
Darkened Storage Room
A heavy, constricting atmosphere surrounds you.

>e
Cases & Calamity
To the east, empty glass display cases line the wall, one of which is smashed, possibly targeted in a robbery of some sort. You stop yourself just before stepping directly into a pile of glass shards. When was this place last cleaned?

>n
You can't go that way.

>s
You can't go that way.

>w
Darkened Storage Room
A heavy, constricting atmosphere surrounds you.

>e
Cases & Calamity
To the east, empty glass display cases line the wall, one of which is smashed, possibly targeted in a robbery of some sort. You stop yourself just before stepping directly into a pile of glass shards. When was this place last cleaned?

* * *

>w
Darkened Storage Room
A heavy, constricting atmosphere surrounds you.

>n
Plaques & Papers
To the north are stacks of chairs and wooden slabs, golden engravings nailed into each of them. Papers with incomprhensible scrawls are scattered all over the floor. If you squint, you can see a vent on the wall. Could you somehow reach that?

* * *

I beg your pardon?

>take
(Carboard box)
Taken.

* * *

>n
Plaques & Papers
To the north are stacks of metal chairs and wooden slabs, golden engravings nailed into each of them. Papers with incomprhensible scrawls are scattered all over the floor. Photographs of animals are attached to some of the papers

One metal chair has fallen from the stack and is on the floor.

If you squint, you can also see a vent on the wall. Could you somehow reach that?

>enter metal chair
The chair is too tall to climb onto... You'd need some sort of boost. What was back in the other rooms?

* * *

>X
()
You sniff around the boxes and papers, observing cursive scrawl that you cannot understand. Photographs of animals are attached to some of the papers.

>X
()
You sniff around the boxes and papers, observing cursive scrawl that you cannot understand. Photographs of animals are attached to some of the papers.

* * *

>destroy
( with )
The impact isn't enough to fully shatter the bars.

>destroy loose bar
Violence isn't the answer to this one.

>destroy loose bar with antlers
You can't see any such thing.

* * *

>destroy bar
You can't see any such thing.

* * *

>destroy loose bar with
You can't see any such thing.

>destroy loose bar with me
You can't see any such thing.

>destroy loose bar with loose bar
You can't see any such thing.

* * *

>enter dusty vent
You can't see any such thing.

>n
plaques & papers
To the north are stacks of metal chairs and wooden slabs, golden engravings nailed into each of them. Papers with incomprhensible scrawls are scattered all over the floor. Photographs of animals are attached to some of the papers

If you squint, you can also see a vent on the wall. Could you somehow reach that? 

A single metal chair has fallen from the stack and is on the floor.

>enter dusty vent
The vent sits frustratingly out of reach.

>ckimb chair
That's not a verb I recognise.

>climb chair
The chair is too tall to climb onto... You'd need some sort of boost. What was back in the other rooms?

* * *

>escape
You get out of the cage.

Awakening
You can see a cage (empty) here.

>n
You would have to get out of the cage first.

>exit
Wriggling your way through the hole, you quietly slink around the cage and look forward. 
You have a slightly better view of the room now and get a full idea of just how large the room is compared to you, boxes and furniture towering imposingly above

>n
You would have to get out of the cage first.

>exit cage
I only understood you as far as wanting to exit.

>exit the cage
I only understood you as far as wanting to exit.

* * *

>exit
But you aren't in anything at the moment.

* * *

>n
Plaques & Papers
To the north are stacks of metal chairs and wooden slabs, golden engravings nailed into each of them. Papers with incomprehensible scrawls are scattered all over the floor. Photographs of animals are attached to some of the papers.

If you squint, you can also see a vent on the wall. Could you somehow reach that?

A single metal chair has fallen from the stack and is on the floor.

>climb chair
The lone metal chair is too tall to climb onto... You'd need some sort of boost. What was back in the other rooms?

>s
(first getting off Metal chair)

Darkened storage room
A heavy, constricting atmosphere surrounds you.

Various boxes, small and large, are scattered about on the ground.

>take
(Box)
Taken.

>n
plaques & papers
One chair stack is tilting so far that it could very well pass as an off-brand Leaning Tower of Pisa.

 

A single metal chair has fallen from the stack and is on the floor.

>climb chair
You use the box as a stool to clamber onto the chair. The vent is now in reach.

plaques & papers (on Metal chair)
One chair stack is tilting so far that it could very well pass as an off-brand Leaning Tower of Pisa.

>enter vent
You squeeze into the dusty vent, tip-toeing forward. At the end is an opening, and you carefully hop out.

Hall of Wonder
This new room is also dark, but you spy a red exit sign further north glowing softly. You make a run for it, the light getting closer...

Until you hear a faint clicking sound. Blinding and bold, a beam of light strikes you from above, and then, like a twisted domino effect, each section of the room slowly comes to life. Its enormous, the exit sign's glow now washed away by the curious sights around you.

Plants and flowers spiral up the walls of the room, inspired by the outside world. Tapestries resembling a perfect blue sky hang from the ceiling. A lion gazes into the distance, surveying its kingdom.

A hawk swoops down, talons searching for prey. A mighty moose stamps the ground, a warning to those in its way. But they are all dead, so very dead.

Going back would be an option if it wasn't for the sudden bang behind you signaling that the dusty vent had collapsed inwards. You have to make a run north for it..!

* * *

>n
Plaques & Papers
To the north are stacks of metal chairs and wooden slabs, golden engravings nailed into each of them. Papers with incomprehensible scrawls are scattered all over the floor. Photographs of animals are attached to some of the papers.

If you squint, you can also see a vent on the wall. Could you somehow reach that?

A single metal chair has fallen from the stack and is on the floor.

>climb on chair
The chair is too tall to climb onto... You'd need some sort of boost. What was back in the other rooms?

>n
(first getting off Metal chair)

Hall of Wonder
This new room is also dark, but you spy a red exit sign further north glowing softly. You make a run for it, the light getting closer...

Until you hear a faint clicking sound. Blinding and bold, a beam of light strikes you from above, and then, like a twisted domino effect, each section of the room slowly comes to life. Its enormous, the exit sign's glow now washed away by the curious sights around you.

Plants and flowers spiral up the walls of the room, inspired by the outside world. Tapestries resembling a perfect blue sky hang from the ceiling. A lion gazes into the distance, surveying its kingdom.

A hawk swoops down, talons searching for prey. A mighty moose stamps the ground, a warning to those in its way. But they are all dead, so very dead.

You can go back now or make a run north for it- either way, this isn't looking too good.

aa

* * *

>n
Plaques & Papers
To the north are stacks of metal chairs and wooden slabs, golden engravings nailed into each of them. Papers with incomprehensible scrawls are scattered all over the floor. Photographs of animals are attached to some of the papers.

If you squint, you can also see a vent on the wall. Could you somehow reach that?

A single metal chair has fallen from the stack and is on the floor.

>climb onto chair
The chair is too tall to climb onto... You'd need some sort of boost. What was back in the other rooms?

>s
(first getting off Metal chair)

Darkened storage room
A heavy, constricting atmosphere surrounds you 

Various boxes, small and large, are scattered about on the ground.

>w
Darkness
The room is completely dark, a low whirring of a fan its only sound.

>s
You can't go that way.

>n
You can't go that way.

>e
Darkened storage room
you feel uneasy and exposed.

Various boxes, small and large, are scattered about on the ground.

>t
That's not a verb I recognise.

>take
(Box)
Taken.

>n
Plaques & Papers
One chair stack is tilting so far that it could very well pass as an off-brand Leaning Tower of Pisa.

One metal chair has fallen from the stack and is on the floor.

* * *

>n
Plaques & Papers
To the north are stacks of metal chairs and wooden slabs, golden engravings nailed into each of them. Papers with incomprehensible scrawls are scattered all over the floor. Photographs of animals are attached to some of the papers.

If you squint, you can also see a vent on the wall. Could you somehow reach that?

A single metal chair has fallen from the stack and is on the floor.

>enter vent
You can't see any such thing.

>enter dusty vent
You can't see any such thing.

* * *

>n
Plaques & Papers
To the north are stacks of metal chairs and wooden slabs, golden engravings nailed into each of them. Papers with incomprehensible scrawls are scattered all over the floor. Photographs of animals are attached to some of the papers.

If you squint, you can also see a vent on the wall. Could you somehow reach that?

A single metal chair has fallen from the stack and is on the floor.

>n
You squeeze into the rusty vent, tip-toeing forward. At the end is an opening, and you carefully hop out.

Hall of Wonder

Though dark, you spy a red exit sign further north glowing softly. You make a run for it, the light getting closer...

Until you hear a faint clicking sound. Blinding and bold, a beam of light strikes you from above, and then, like a twisted domino effect, each section of the room slowly comes to life. Its enormous, the exit sign's glow now washed away by the curious sights around you.

Plants and flowers spiral up the walls of the room, inspired by the outside world. Tapestries resembling a perfect blue sky hang from the ceiling. A lion gazes into the distance, surveying its kingdom.

A hawk swoops down, talons searching for prey. A mighty moose stamps the ground, a warning to those in its way. But they are all dead, so very dead.

And in the middle of it all is a man. The type of bougie guy with one of those evil villain mustaches. He's grasping a bottle of alcohol- and, glancing at you once, twice, he downs the rest of it and tosses it.

He squats down, staring like he'd seen god himself. He shakily raises his finger, the whole world stopping for a moment before he shouts,

"RABBIT!!!!!"

run, NOW!!

>n
You can't go that way.

>s
You squeeze into the rusty vent, tip-toeing forward. At the end is an opening, and you carefully hop out.

Hall of Wonder

* * *

>n
Plaques & Papers
To the north are stacks of metal chairs and wooden slabs, golden engravings nailed into each of them. Papers with incomprehensible scrawls are scattered all over the floor. Photographs of animals are attached to some of the papers.

If you squint, you can also see a vent on the wall. Could you somehow reach that?

A single metal chair has fallen from the stack and is on the floor.

>s
Darkened Storage Room
A heavy, constricting atmosphere surrounds you.

Various boxes, small and large, are scattered about on the ground.

>e
Cases & Calamity
To the east, empty glass display cases line the wall, one of which is smashed, possibly targeted in a robbery of some sort. You stop yourself just before stepping directly into a pile of glass shards. When was this place last cleaned?

>s
You can't go that way.

>e
You can't go that way.

>n
Dusty vent
test.

>s
You can't go that way.

>w
You can't go that way.

>e
You can't go that way.

>n
Hall of Wonder
test2.

>s
You can't go that way.

* * *

>e
Cases & Calamity
To the east, empty glass display cases line the wall, one of which is smashed, possibly targeted in a robbery of some sort. You stop yourself just before stepping directly into a pile of glass shards. When was this place last cleaned?

>w
Darkened Storage Room
you feel uneasy and exposed.

>s
You can't go that way.

>w
Darkness
The room is completely dark, a low whirring of a fan its only sound.

>n
You can't go that way.

* * *

>w
You can't go that way.

>e
Darkened Storage Room
A heavy, constricting atmosphere surrounds you

>n
Plaques & Papers
To the north are stacks of metal chairs and wooden slabs, golden engravings nailed into each of them. Papers with incomprhensible scrawls are scattered all over the floor. Photographs of animals are attached to some of the papers. If you squint, you can see a vent on the wall to the north. Could you somehow reach that?

One metal chair has fallen from the stack and is on the floor

* * *

>s
Darkened Storage Room
A heavy, constricting atmosphere surrounds you.

Various boxes, small and large, are scattered about on the ground.

>n
Plaques & Papers
One chair stack is tilting so far that it could very well pass as an off-brand Leaning Tower of Pisa.

 

A single metal chair has fallen from the stack and is on the floor.

>s
Darkened Storage Room
you feel uneasy and exposed.

Various boxes, small and large, are scattered about on the ground.

>take
(Box)
Taken.

* * *

>n
Plaques & Papers
One chair stack is tilting so far that it could very well pass as an off-brand Leaning Tower of Pisa.

 

A single metal chair has fallen from the stack and is on the floor.

>climb
What do you want to climb?

>chair
You use the box as a stool to clamber onto the chair. The vent is now in reach.

Plaques & Papers (on Metal chair)
One chair stack is tilting so far that it could very well pass as an off-brand Leaning Tower of Pisa.

>enetr vent
That's not a verb I recognise.

>enter vent
You squeeze into the dusty vent, tip-toeing forward. At the end is an opening, and you carefully hop out.

Hall of Wonder
This new room is also dark, but you spy a red exit sign further north glowing softly. You make a run for it, the light getting closer...

Until you hear a faint clicking sound. Blinding and bold, a beam of light strikes you from above, and then, like a twisted domino effect, each section of the room slowly comes to life. Its enormous, the exit sign's glow now washed away by the curious sights around you.

Plants and flowers spiral up the walls of the room, inspired by the outside world. Tapestries resembling a perfect blue sky hang from the ceiling. A lion gazes into the distance, surveying its kingdom.

A hawk swoops down, talons searching for prey. A mighty moose stamps the ground, a warning to those in its way. But they are all dead, so very dead.

Going back would be an option if it wasn't for the sudden bang behind you signaling that the dusty vent had collapsed inwards. Going North seems like your best option, but there's a more discreet route westbound of the room.

>w
Bravest Who Proceed
Without wasting another second, you dash to the left, avoiding the center of the room and manuevering through the taixdermied animals, using them as protection agaist detection. They shield you from their own fate.

>s
it collapsed.

>s
it collapsed.

* * *

>n
Plaques & Papers
One chair stack is tilting so far that it could very well pass as an off-brand Leaning Tower of Pisa.

 

A single metal chair has fallen from the stack and is on the floor.

>climb into vent
You can't see any such thing.

>enter vent
The vent sits frustratingly out of reach.

>climb chair
You use the box as a stool to clamber onto the chair. The vent is now in reach.

Plaques & Papers (on Metal chair)
One chair stack is tilting so far that it could very well pass as an off-brand Leaning Tower of Pisa.

* * *

>w
Bravest Who Proceed
Without wasting another second, you dash to the left, avoiding the center of the room and manuevering through the taixdermied animals, using them as protection agaist detection. They shield you from their own fate.

It's a good thing you went this way.. you can now see a hunter standing in the middle of the room, confused as to why the lights came on.

>w
Exiting Concealed
Using the westbound route, you continue.

As you continue towards the exit, you find a note on the floor. Hidden from The Hunter, you quickly read it. To those who read this: You've made it far, and you don't know me. But, I can tell you this- You were never alone. I weakened the loose bar, another placed the chair. Someone was made to survive this- and it must be you. Every animal made it possible, and now I will tell you with finality- the exit at the end of the room is locked. Check the ground. A switch is there.

>w
You can't go that way.

>undo
Exiting Concealed
[Previous turn undone.]

>undo
Bravest Who Proceed
[Previous turn undone.]

>undo
Hall of Wonder
[Previous turn undone.]

>redo
That's not a verb I recognise.

>n
Ring of Fire
What you'd failed to notice, hidden among his collection, was a hunter.

He's in his pajamas (must be nice), grasping a bottle of alcohol- and, glancing at you once, twice, he downs the rest of it and tosses it.

With you now in his line of sight, he squats down, staring like he'd seen a unicorn. He shakily raises his finger, the whole world stopping for a moment before he shouts,

"RABBIT!!!!!"

RUN! Whenever they catch you, they will kill you. But first they must catch you, digger, listener, runner, prince with the swift warning.

>n
Exit ?
In a blink, the hunter sprints after you- fast, make a decision! Can you kill him?

>kill the hunter with antlers
The Hunter, unsteady, cannot react in time as you ram into him with your antlers. He falls backwards with a great crash, completely stunned by your quick line of attack. FInally, feeling triumphant, you walk up to the exit. But.. it's jammed. No matter what you do, the door doesn't budge.

    *** FALSE ENDING. ***

Would you like to RESTART, RESTORE a saved game, QUIT or UNDO the last command?

>undo
Exit ?
[Previous turn undone.]

>undo
Ring of Fire
[Previous turn undone.]

>undo
Hall of Wonder
[Previous turn undone.]

>w
Bravest Who Proceed
Without wasting another second, you dash to the left, avoiding the center of the room and manuevering through the taixdermied animals, using them as protection agaist detection. They shield you from their own fate.

It's a good thing you went this way.. you can now see a hunter standing in the middle of the room, confused as to why the lights came on.

* * *

>w
You can't go that way.

>look
You search the ground and find the switch. Pressing it, part of the wall shifts in the room. Sunlight creeps into the hole- you look back once more, promising to warn the rest of the animal kingdom of The Hunter. You run as fast as you can, escaping the awful place for good.

    *** TRUE ENDING. ***

Would you like to RESTART, RESTORE a saved game, QUIT or UNDO the last command?

* * *

>s
Darkened Storage Room
A heavy, constricting atmosphere surrounds you.

Various boxes, small and large, are scattered about on the ground.

>w
Darkness
The room is completely dark, a low whirring of a fan its only sound

>e
You can't go that way.

* * *

>w
Darkness
The room is completely dark, a low whirring of a fan its only sound

>s
You can't go that way.

>n
Darkened Storage Room
check

* * *

>n
Plaques & Papers
To the north are stacks of metal chairs and wooden slabs, golden engravings nailed into each of them. Papers with incomprehensible scrawls are scattered all over the floor. Photographs of animals are attached to some of the papers.

If you squint, you can also see a vent on the wall. Could you somehow reach that?

A single metal chair has fallen from the stack and is on the floor.

>stand on chair
You get onto Metal chair.

>enter dusty vent
You squeeze into the rusty vent, tip-toeing forward. At the end is an opening, and you carefully hop out.

Hall of Wonder

Though dark, you spy a red exit sign further north glowing softly. You make a run for it, the light getting closer...

Until you hear a faint clicking sound. Blinding and bold, a beam of light strikes you from above, and then, like a twisted domino effect, each section of the room slowly comes to life. Its enormous, the exit sign's glow now washed away by the curious sights around you.

Plants and flowers spiral up the walls of the room, inspired by the outside world. Tapestries resembling a perfect blue sky hang from the ceiling. A lion gazes into the distance, surveying its kingdom.

A hawk swoops down, talons searching for prey. A mighty moose stamps the ground, a warning to those in its way. But they are all dead, so very dead.

And in the middle of it all is a man. The type of bougie guy with one of those evil villain mustaches. He's grasping a bottle of alcohol- and, glancing at you once, twice, he downs the rest of it and tosses it.

He squats down, staring like he'd seen god himself. He shakily raises his finger, the whole world stopping for a moment before he shouts,

"RABBIT!!!!!"

run, NOW!!

* * *

>n
Plaques & Papers
To the north are stacks of metal chairs and wooden slabs, golden engravings nailed into each of them. Papers with incomprehensible scrawls are scattered all over the floor. Photographs of animals are attached to some of the papers.

If you squint, you can also see a vent on the wall. Could you somehow reach that?

A single metal chair has fallen from the stack and is on the floor.

>w
Darkened Storage Room D
d

>e
Darkened Storage Room

>s
Darkened Storage Room B
b

* * *

>n
Plaques & Papers
To the north are stacks of metal chairs and wooden slabs, golden engravings nailed into each of them. Papers with incomprehensible scrawls are scattered all over the floor. Photographs of animals are attached to some of the papers.

If you squint, you can also see a vent on the wall. Could you somehow reach that?

A single metal chair has fallen from the stack and is on the floor.

>x
()
A.

>n
You squeeze into the rusty vent, tip-toeing forward. At the end is an opening, and you carefully hop out.

Hall of Wonder

Though dark, you spy a red exit sign further north glowing softly. You make a run for it, the light getting closer...

Until you hear a faint clicking sound. Blinding and bold, a beam of light strikes you from above, and then, like a twisted domino effect, each section of the room slowly comes to life. Its enormous, the exit sign's glow now washed away by the curious sights around you.

Plants and flowers spiral up the walls of the room, inspired by the outside world. Tapestries resembling a perfect blue sky hang from the ceiling. A lion gazes into the distance, surveying its kingdom.

A hawk swoops down, talons searching for prey. A mighty moose stamps the ground, a warning to those in its way. But they are all dead, so very dead.

And in the middle of it all is a man. The type of bougie guy with one of those evil villain mustaches. He's grasping a bottle of alcohol- and, glancing at you once, twice, he downs the rest of it and tosses it.

He squats down, staring like he'd seen god himself. He shakily raises his finger, the whole world stopping for a moment before he shouts,

"RABBIT!!!!!"

run, NOW!!

* * *

>s
You can't go that way.

>e
Cases & Calamity
To the east, empty glass display cases line the wall, one of which is smashed, possibly targeted in a robbery of some sort. You stop yourself just before stepping directly into a pile of glass shards. When was this place last cleaned?

>w
Darkened Storage Room
A heavy, constricting atmosphere surrounds you.

>w
Darkness
The room is completely dark, a low whirring of a fan its only sound

>w
You can't go that way.

>n
You can't go that way.

* * *

>e
You can't go that way.

>w
You can't go that way.

>s
You can't go that way.

>d
You can't go that way.

>w
You can't go that way.

* * *

>e
You can't go that way.

>n
You can't go that way.

* * *

>s
You can't go that way.

>n
plaques & papers
To the north are stacks of metal chairs and wooden slabs, golden engravings nailed into each of them. Papers with incomprhensible scrawls are scattered all over the floor. Photographs of animals are attached to some of the papers

If you squint, you can also see a vent on the wall. Could you somehow reach that? 

A single metal chair has fallen from the stack and is on the floor.

>climb
()
Little is to be achieved by that.

>climb chair
The lone metal chair is too tall to climb onto... You'd need some sort of boost. What was back in the other rooms?

* * *

>climb chair
You use the box as a stool to clamber onto the chair. The vent is now in reach.

plaques & papers (on Metal chair)
One chair stack is tilting so far that it could very well pass as an off-brand Leaning Tower of Pisa.

>enter vent
You squeeze into the dusty vent, tip-toeing forward. At the end is an opening, and you carefully hop out.

Hall of Wonder
This new room is also dark, but you spy a red exit sign further north glowing softly. You make a run for it, the light getting closer...

Until you hear a faint clicking sound. Blinding and bold, a beam of light strikes you from above, and then, like a twisted domino effect, each section of the room slowly comes to life. Its enormous, the exit sign's glow now washed away by the curious sights around you.

Plants and flowers spiral up the walls of the room, inspired by the outside world. Tapestries resembling a perfect blue sky hang from the ceiling. A lion gazes into the distance, surveying its kingdom.

A hawk swoops down, talons searching for prey. A mighty moose stamps the ground, a warning to those in its way. But they are all dead, so very dead.

Going back would be an option if it wasn't for the sudden bang behind you signaling that the dusty vent had collapsed inwards. Going North seems like your best option, but there's a more discreet route westbound of the room.

>n
Ring of Fire
What you'd failed to notice, hidden among his collection, was a man.

He's in his pajamas (must be nice), grasping a bottle of alcohol- and, glancing at you once, twice, he downs the rest of it and tosses it.

With you now in his line of sight, he squats down, staring like he'd seen a unicorn. He shakily raises his finger, the whole world stopping for a moment before he shouts,

"RABBIT!!!!!"

run, NOW!!

>s
Hall of Wonder

If you squint, you can also see a vent on the wall. Could you somehow reach that?

* * *

>t
That's not a verb I recognise.

* * *

>taje
That's not a verb I recognise.

>take
(Box)
Taken.

* * *

>n
plaques & papers
To the north are stacks of metal chairs and wooden slabs, golden engravings nailed into each of them. Papers with incomprhensible scrawls are scattered all over the floor. Photographs of animals are attached to some of the papers

If you squint, you can also see a vent on the wall. Could you somehow reach that? 

A single metal chair has fallen from the stack and is on the floor.

>climb chair
You use the box as a stool to clamber onto the chair. The vent is now in reach.

plaques & papers (on Metal chair)
One chair stack is tilting so far that it could very well pass as an off-brand Leaning Tower of Pisa.

>enter dusty vent
You squeeze into the dusty vent, tip-toeing forward. At the end is an opening, and you carefully hop out.

Hall of Wonder
This new room is also dark, but you spy a red exit sign further north glowing softly. You make a run for it, the light getting closer...

Until you hear a faint clicking sound. Blinding and bold, a beam of light strikes you from above, and then, like a twisted domino effect, each section of the room slowly comes to life. Its enormous, the exit sign's glow now washed away by the curious sights around you.

Plants and flowers spiral up the walls of the room, inspired by the outside world. Tapestries resembling a perfect blue sky hang from the ceiling. A lion gazes into the distance, surveying its kingdom.

A hawk swoops down, talons searching for prey. A mighty moose stamps the ground, a warning to those in its way. But they are all dead, so very dead.

You can go back now or make a run north for it- either way, this isn't looking too good.

>s
it collapsed.

>enter dusty vent
nuh uh.

* * *

>take
(Box)
Taken.

>look
Darkened Storage Room
A heavy, constricting atmosphere surrounds you.

>n
Plaques & Papers
To the north are stacks of metal chairs and wooden slabs, golden engravings nailed into each of them. Papers with incomprhensible scrawls are scattered all over the floor. Photographs of animals are attached to some of the papers

If you squint, you can also see a vent on the wall. Could you somehow reach that?

A single metal chair has fallen from the stack and is on the floor.

>climb chair
You use the box as a stool to clamber onto the chair. The vent is now in reach.

Plaques & Papers (on Metal chair)
One chair stack is tilting so far that it could very well pass as an off-brand Leaning Tower of Pisa.

>enter
But you're already on Metal chair.

>enter vent
You squeeze into the dusty vent, tip-toeing forward. At the end is an opening, and you carefully hop out.

Hall of Wonder
This new room is also dark, but you spy a red exit sign further north glowing softly. You make a run for it, the light getting closer...

Until you hear a faint clicking sound. Blinding and bold, a beam of light strikes you from above, and then, like a twisted domino effect, each section of the room slowly comes to life. Its enormous, the exit sign's glow now washed away by the curious sights around you.

Plants and flowers spiral up the walls of the room, inspired by the outside world. Tapestries resembling a perfect blue sky hang from the ceiling. A lion gazes into the distance, surveying its kingdom.

A hawk swoops down, talons searching for prey. A mighty moose stamps the ground, a warning to those in its way. But they are all dead, so very dead.

Going back would be an option if it wasn't for the sudden bang behind you signaling that the dusty vent had collapsed inwards. Going North seems like your best option, but there's a more discreet route westbound of the room.

>l
Hall of Wonder

>look
Hall of Wonder

If you squint, you can also see a vent on the wall. Could you somehow reach that?

>look
Hall of Wonder

* * *

>take
(Box)
Taken.

>n
Plaques & Papers
To the north are stacks of metal chairs and wooden slabs, golden engravings nailed into each of them. Papers with incomprehensible scrawls are scattered all over the floor. Photographs of animals are attached to some of the papers.

If you squint, you can also see a vent on the wall. Could you somehow reach that?

A single metal chair has fallen from the stack and is on the floor.

>n
(first opening the dusty vent)
It seems to be locked.

>n
(first opening the dusty vent)
It seems to be locked.

>w
You can't go that way.

>s
Darkened storage room
A heavy, constricting atmosphere surrounds you

* * *

>n
Plaques & Papers
To the north are stacks of metal chairs and wooden slabs, golden engravings nailed into each of them. Papers with incomprehensible scrawls are scattered all over the floor. Photographs of animals are attached to some of the papers.

If you squint, you can also see a vent on the wall. Could you somehow reach that?

A single metal chair has fallen from the stack and is on the floor.

>climb
What do you want to climb?

* * *

>chair
You use the box as a stool to clamber onto the chair. The vent is now in reach.

Plaques & Papers (on Metal chair)
One chair stack is tilting so far that it could very well pass as an off-brand Leaning Tower of Pisa.

>enter vent
You squeeze into the dusty vent, tip-toeing forward. At the end is an opening, and you carefully hop out.

Hall of Wonder
This new room is also dark, but you spy a red exit sign further north glowing softly. You make a run for it, the light getting closer...

Until you hear a faint clicking sound. Blinding and bold, a beam of light strikes you from above, and then, like a twisted domino effect, each section of the room slowly comes to life. Its enormous, the exit sign's glow now washed away by the curious sights around you.

Plants and flowers spiral up the walls of the room, inspired by the outside world. Tapestries resembling a perfect blue sky hang from the ceiling. A lion gazes into the distance, surveying its kingdom.

A hawk swoops down, talons searching for prey. A mighty moose stamps the ground, a warning to those in its way. But they are all dead, so very dead.

Going back would be an option if it wasn't for the sudden bang behind you signaling that the dusty vent had collapsed inwards. Going North seems like your best option, but there's a more discreet route westbound of the room.

* * *

>n
Ring of Fire
What you'd failed to notice, hidden among his collection, was a man.

He's in his pajamas (must be nice), grasping a bottle of alcohol- and, glancing at you once, twice, he downs the rest of it and tosses it.

With you now in his line of sight, he squats down, staring like he'd seen a unicorn. He shakily raises his finger, the whole world stopping for a moment before he shouts,

"RABBIT!!!!!"

run, NOW!!

>s
The vent is collapsed- That's a dead end!

>w
You can't go that way.

* * *

>s
The vent is completely caved in, there's no way back.

>w
Brave Proceed
Without wasting another second, you dash to the left, avoiding the center of the room and manuevering through the taixdermied animals, using them as protection agaist detection.

* * *

>w
Bravest Who Proceed
Without wasting another second, you dash to the left, avoiding the center of the room and manuevering through the taixdermied animals, using them as protection agaist detection. They shield you from their own fate.

>s
You can't go back to the vent- it's collapsed!.

* * *

>chair
You use the box as a stool to clamber onto the chair. The vent is now in reach.

Plaques & Papers (on Metal chair)
One chair stack is tilting so far that it could very well pass as an off-brand Leaning Tower of Pisa.

>go into vent
You squeeze into the dusty vent, tip-toeing forward. At the end is an opening, and you carefully hop out.

Hall of Wonder
This new room is also dark, but you spy a red exit sign further north glowing softly. You make a run for it, the light getting closer...

Until you hear a faint clicking sound. Blinding and bold, a beam of light strikes you from above, and then, like a twisted domino effect, each section of the room slowly comes to life. Its enormous, the exit sign's glow now washed away by the curious sights around you.

Plants and flowers spiral up the walls of the room, inspired by the outside world. Tapestries resembling a perfect blue sky hang from the ceiling. A lion gazes into the distance, surveying its kingdom.

A hawk swoops down, talons searching for prey. A mighty moose stamps the ground, a warning to those in its way. But they are all dead, so very dead.

Going back would be an option if it wasn't for the sudden bang behind you signaling that the dusty vent had collapsed inwards. Going North seems like your best option, but there's a longer route westbound of the room.

* * *

>chair
You use the box as a stool to clamber onto the chair. The vent is now in reach.

Plaques & Papers (on Metal chair)
One chair stack is tilting so far that it could very well pass as an off-brand Leaning Tower of Pisa.

>w
(first getting off Metal chair)
You can't go that way.

>s
Darkened storage room
A heavy, constricting atmosphere surrounds you.

>n
plaques & papers
One chair stack is tilting so far that it could very well pass as an off-brand Leaning Tower of Pisa.

 

A single metal chair has fallen from the stack and is on the floor.

>climb
What do you want to climb?

* * *

>chair
You use the box as a stool to clamber onto the chair. The vent is now in reach.

plaques & papers (on Metal chair)
One chair stack is tilting so far that it could very well pass as an off-brand Leaning Tower of Pisa.

>enter vent
You squeeze into the dusty vent, tip-toeing forward. At the end is an opening, and you carefully hop out.

Hall of Wonder
This new room is also dark, but you spy a red exit sign further north glowing softly. You make a run for it, the light getting closer...

Until you hear a faint clicking sound. Blinding and bold, a beam of light strikes you from above, and then, like a twisted domino effect, each section of the room slowly comes to life. Its enormous, the exit sign's glow now washed away by the curious sights around you.

Plants and flowers spiral up the walls of the room, inspired by the outside world. Tapestries resembling a perfect blue sky hang from the ceiling. A lion gazes into the distance, surveying its kingdom.

A hawk swoops down, talons searching for prey. A mighty moose stamps the ground, a warning to those in its way. But they are all dead, so very dead.

Going back would be an option if it wasn't for the sudden bang behind you signaling that the dusty vent had collapsed inwards. Going North seems like your best option, but there's a more discreet route westbound of the room.

If you squint, you can also see a vent on the wall. Could you somehow reach that?

* * *

>climb
What do you want to climb?

>metal chair
Little is to be achieved by that.

>climb metal chair
Little is to be achieved by that.

>get onto chair
The chair is too tall to climb onto... You'd need some sort of boost. What was back in the other rooms?

You get onto Metal chair.

>enter dusty vent
You squeeze into the rusty vent, tip-toeing forward. At the end is an opening, and you carefully hop out.

Hall of Wonder

Though dark, you spy a red exit sign further north glowing softly. You make a run for it, the light getting closer...

Until you hear a faint clicking sound. Blinding and bold, a beam of light strikes you from above, and then, like a twisted domino effect, each section of the room slowly comes to life. Its enormous, the exit sign's glow now washed away by the curious sights around you.

Plants and flowers spiral up the walls of the room, inspired by the outside world. Tapestries resembling a perfect blue sky hang from the ceiling. A lion gazes into the distance, surveying its kingdom.

A hawk swoops down, talons searching for prey. A mighty moose stamps the ground, a warning to those in its way. But they are all dead, so very dead.

You can go back now or make a run north for it- either way, this isn't looking too good.

* * *

>n
Plaques & Papers
To the north are stacks of metal chairs and wooden slabs, golden engravings nailed into each of them. Papers with incomprehensible scrawls are scattered all over the floor. Photographs of animals are attached to some of the papers.

If you squint, you can also see a vent on the wall. Could you somehow reach that?

A single metal chair has fallen from the stack and is on the floor.

>climb chair
You use the box as a stool to clamber onto the chair. The vent is now in reach.

Plaques & Papers (on Metal chair)
One chair stack is tilting so far that it could very well pass as an off-brand Leaning Tower of Pisa.

>climb chair
But you're already on Metal chair.

>enter vent
You squeeze into the dusty vent, tip-toeing forward. At the end is an opening, and you carefully hop out.

Hall of Wonder
This new room is also dark, but you spy a red exit sign further north glowing softly. You make a run for it, the light getting closer...

Until you hear a faint clicking sound. Blinding and bold, a beam of light strikes you from above, and then, like a twisted domino effect, each section of the room slowly comes to life. Its enormous, the exit sign's glow now washed away by the curious sights around you.

Plants and flowers spiral up the walls of the room, inspired by the outside world. Tapestries resembling a perfect blue sky hang from the ceiling. A lion gazes into the distance, surveying its kingdom.

A hawk swoops down, talons searching for prey. A mighty moose stamps the ground, a warning to those in its way. But they are all dead, so very dead.

Going back would be an option if it wasn't for the sudden bang behind you signaling that the dusty vent had collapsed inwards. Going North seems like your best option, but there's a more discreet route westbound of the room.

* * *

>n
Exit ?
In a blink, the hunter sprints after you- fast, make a decision! Can you attack or kill him?

>n
You can't go that way.

You hunter continues to pursue you!.

>n
You can't go that way.

    *** You run, but you're not fast enough ***

Would you like to RESTART, RESTORE a saved game, QUIT or UNDO the last command?

* * *

>climb chair
You use the box as a stool to clamber onto the chair. The vent is now in reach.

Plaques & Papers (on Metal chair)
One chair stack is tilting so far that it could very well pass as an off-brand Leaning Tower of Pisa.

>climb into vent
You can't see any such thing.

>enter vent
You squeeze into the dusty vent, tip-toeing forward. At the end is an opening, and you carefully hop out.

Hall of Wonder
This new room is also dark, but you spy a red exit sign further north glowing softly. You make a run for it, the light getting closer...

Until you hear a faint clicking sound. Blinding and bold, a beam of light strikes you from above, and then, like a twisted domino effect, each section of the room slowly comes to life. Its enormous, the exit sign's glow now washed away by the curious sights around you.

Plants and flowers spiral up the walls of the room, inspired by the outside world. Tapestries resembling a perfect blue sky hang from the ceiling. A lion gazes into the distance, surveying its kingdom.

A hawk swoops down, talons searching for prey. A mighty moose stamps the ground, a warning to those in its way. But they are all dead, so very dead.

Going back would be an option if it wasn't for the sudden bang behind you signaling that the dusty vent had collapsed inwards. Going North seems like your best option, but there's a more discreet route westbound of the room.

* * *

>n
Exit ?
In a blink, the hunter sprints after you- fast, make a decision! Can you kill him?

>attack hunter
Violence isn't the answer to this one.

    *** You run and dodge, but you're not fast enough. The hunter catches you before you can reach the exit. ***

Would you like to RESTART, RESTORE a saved game, QUIT or UNDO the last command?

* * *

>n
Exit ?
In a blink, the hunter sprints after you- fast, make a decision! Can you kill him?

>e
You can't go that way.

You hunter continues to pursue you!

>w
You can't go that way.

 Your can hear the hunter's footsteps right behind yours.

>n
You can't go that way.

 You dash between between the taxidermies, the exit slowly getting closer.

>n
You can't go that way.

You hunter continues to pursue you!

>n
You can't go that way.

 Your can hear the hunter's footsteps right behind yours.

>n
You can't go that way.

 You dash between between the taxidermies, the exit slowly getting closer.

>n
You can't go that way.

    *** You run and dodge, but you're not fast enough. The hunter catches you before you can reach the exit. BAD ENDING ***

Would you like to RESTART, RESTORE a saved game, QUIT or UNDO the last command?

* * *

>n
Exit ?
In a blink, the hunter sprints after you- fast, make a decision! Can you kill him?

>kill
What do you want to kill?

>hunter
Violence isn't the answer to this one.

>kill hunter with antlers
    *** You kill the hunter and find an exit. ***

Would you like to RESTART, RESTORE a saved game, QUIT or UNDO the last command?

* * *

>n
Exit ?
In a blink, the hunter sprints after you- fast, make a decision! Can you kill him?

>kill hunter with antlers
    *** You kill the hunter and find an exit. ***

Would you like to RESTART, RESTORE a saved game, QUIT or UNDO the last command?

* * *

>n
Exit ?
In a blink, the hunter sprints after you- fast, make a decision! Can you kill him?

>n
You can't go that way.

You hunter continues to pursue you!.

>n
You can't go that way.

You hunter continues to pursue you!.

>n
You can't go that way.

    *** The hunter kills you ***

Would you like to RESTART, RESTORE a saved game, QUIT or UNDO the last command?

* * *

>n
Ring of Fire
What you'd failed to notice, hidden among his collection, was a hunter.

He's in his pajamas (must be nice), grasping a bottle of alcohol- and, glancing at you once, twice, he downs the rest of it and tosses it.

With you now in his line of sight, he squats down, staring like he'd seen a unicorn. He shakily raises his finger, the whole world stopping for a moment before he shouts,

"RABBIT!!!!!"

RUN! Whenever they catch you, they will kill you. But first they must catch you, digger, listener, runner, prince with the swift warning.

>s
Hall of Wonder

* * *

>w
Bravest Who Proceed
Without wasting another second, you dash to the left, avoiding the center of the room and manuevering through the taixdermied animals, using them as protection agaist detection. They shield you from their own fate.

It's a good thing you went this way.. you can now see a hunter standing in the middle of the room, confused as to why the lights came on.

>n
You've already committed, changing directions and risking being seen is too dangerous.

>e
The only way forward now is west.

>w
Exiting Concealed
Using the westbound route, you continue.

As you continue towards the exit, you find a note on the floor. Hidden from The Hunter, you quickly read it. To those who read this: You've made it far, and you don't know me. But, I can tell you this- You were never alone. I weakened the loose bar, another placed the chair. Someone was made to survive this- and it must be you. Every animal made it possible, and now I will tell you with finality- the exit at the end of the room is locked. Check the ground. A switch is there.

You can also see a Switch here.

* * *

>n
Plaques & Papers
To the north are stacks of metal chairs and wooden slabs, golden engravings nailed into each of them. Papers with incomprehensible scrawls are scattered all over the floor. Photographs of animals are attached to some of the papers.

If you squint, you can also see a vent on the wall. Could you somehow reach that?

A single metal chair has fallen from the stack and is on the floor.

>climb metal chair
Little is to be achieved by that.

* * *

>n
Plaques & Papers
To the north are stacks of metal chairs and wooden slabs, golden engravings nailed into each of them. Papers with incomprehensible scrawls are scattered all over the floor. Photographs of animals are attached to some of the papers.

If you squint, you can also see a vent on the wall. Could you somehow reach that?

A single metal chair has fallen from the stack and is on the floor.

>climb on chair
You use the box as a stool to clamber onto the chair. The vent is now in reach.

Plaques & Papers (on Metal chair)
One chair stack is tilting so far that it could very well pass as an off-brand Leaning Tower of Pisa.

>go into vent
You squeeze into the dusty vent, tip-toeing forward. At the end is an opening, and you carefully hop out.

Hall of Wonder
This new room is also dark, but you spy a red exit sign further north glowing softly. You make a run for it, the light getting closer...

Until you hear a faint clicking sound. Blinding and bold, a beam of light strikes you from above, and then, like a twisted domino effect, each section of the room slowly comes to life. Its enormous, the exit sign's glow now washed away by the curious sights around you.

Plants and flowers spiral up the walls of the room, inspired by the outside world. Tapestries resembling a perfect blue sky hang from the ceiling. A lion gazes into the distance, surveying its kingdom.

A hawk swoops down, talons searching for prey. A mighty moose stamps the ground, a warning to those in its way. But they are all dead, so very dead.

Going back would be an option if it wasn't for the sudden bang behind you signaling that the dusty vent had collapsed inwards. Going North seems like your best option, but there's a more discreet route westbound of the room.

>n
Ring of Fire
What you'd failed to notice, hidden among his collection, was a man.

He's in his pajamas (must be nice), grasping a bottle of alcohol- and, glancing at you once, twice, he downs the rest of it and tosses it.

With you now in his line of sight, he squats down, staring like he'd seen a unicorn. He shakily raises his finger, the whole world stopping for a moment before he shouts,

"RABBIT!!!!!"

run, NOW!!

>kill the hunter with antlers
You can't see any such thing.

>n
Exit ?
You can see a Hunter here.

>kill the hunter with antlers
aaa.

* * *

>n
Plaques & Papers
To the north are stacks of metal chairs and wooden slabs, golden engravings nailed into each of them. Papers with incomprehensible scrawls are scattered all over the floor. Photographs of animals are attached to some of the papers.

If you squint, you can also see a vent on the wall. Could you somehow reach that?

A single metal chair has fallen from the stack and is on the floor.

>climb onto chair
You use the box as a stool to clamber onto the chair. The vent is now in reach.

plaques & papers (on Metal chair)
One chair stack is tilting so far that it could very well pass as an off-brand Leaning Tower of Pisa.

>check inventory
You can't see any such thing.

>inventory
You are carrying:
  Carboard box
  Your trusty antlers

* * *

>climb onto chair
You use the box as a stool to clamber onto the chair. The vent is now in reach.

plaques & papers (on Metal chair)
One chair stack is tilting so far that it could very well pass as an off-brand Leaning Tower of Pisa.

>enter dusty vent
You squeeze into the rusty vent, tip-toeing forward. At the end is an opening, and you carefully hop out.

Hall of Wonder

Though dark, you spy a red exit sign further north glowing softly. You make a run for it, the light getting closer...

Until you hear a faint clicking sound. Blinding and bold, a beam of light strikes you from above, and then, like a twisted domino effect, each section of the room slowly comes to life. Its enormous, the exit sign's glow now washed away by the curious sights around you.

Plants and flowers spiral up the walls of the room, inspired by the outside world. Tapestries resembling a perfect blue sky hang from the ceiling. A lion gazes into the distance, surveying its kingdom.

A hawk swoops down, talons searching for prey. A mighty moose stamps the ground, a warning to those in its way. But they are all dead, so very dead.

You can go back now or make a run north for it- either way, this isn't looking too good.

* * *

>climb onto chair
You use the box as a stool to clamber onto the chair. The vent is now in reach.

plaques & papers (on Metal chair)
One chair stack is tilting so far that it could very well pass as an off-brand Leaning Tower of Pisa.

>enter vent
You squeeze into the dusty vent, tip-toeing forward. At the end is an opening, and you carefully hop out.

Hall of Wonder
This new room is also dark, but you spy a red exit sign further north glowing softly. You make a run for it, the light getting closer...

Until you hear a faint clicking sound. Blinding and bold, a beam of light strikes you from above, and then, like a twisted domino effect, each section of the room slowly comes to life. Its enormous, the exit sign's glow now washed away by the curious sights around you.

Plants and flowers spiral up the walls of the room, inspired by the outside world. Tapestries resembling a perfect blue sky hang from the ceiling. A lion gazes into the distance, surveying its kingdom.

A hawk swoops down, talons searching for prey. A mighty moose stamps the ground, a warning to those in its way. But they are all dead, so very dead.

You can go back now or make a run north for it- either way, this isn't looking too good.

>enter dusty vent
The vent sits frustratingly out of reach.

* * *

>climb onto chair
You use the box as a stool to clamber onto the chair. The vent is now in reach.

plaques & papers (on Metal chair)
One chair stack is tilting so far that it could very well pass as an off-brand Leaning Tower of Pisa.

>go into vent
You squeeze into the dusty vent, tip-toeing forward. At the end is an opening, and you carefully hop out.

Hall of Wonder
This new room is also dark, but you spy a red exit sign further north glowing softly. You make a run for it, the light getting closer...

Until you hear a faint clicking sound. Blinding and bold, a beam of light strikes you from above, and then, like a twisted domino effect, each section of the room slowly comes to life. Its enormous, the exit sign's glow now washed away by the curious sights around you.

Plants and flowers spiral up the walls of the room, inspired by the outside world. Tapestries resembling a perfect blue sky hang from the ceiling. A lion gazes into the distance, surveying its kingdom.

A hawk swoops down, talons searching for prey. A mighty moose stamps the ground, a warning to those in its way. But they are all dead, so very dead.

You can go back now or make a run north for it- either way, this isn't looking too good.

 

*** Run-time problem P44: Attempt to remove a door from play.

aa

* * *

>climb onto chair
You use the box as a stool to clamber onto the chair. The vent is now in reach.

plaques & papers (on Metal chair)
One chair stack is tilting so far that it could very well pass as an off-brand Leaning Tower of Pisa.

>inventoru
That's not a verb I recognise.

>inventory
You are carrying:
  Carboard box
  Your trusty antlers

* * *

>n
Plaques & Papers
To the north are stacks of metal chairs and wooden slabs, golden engravings nailed into each of them. Papers with incomprehensible scrawls are scattered all over the floor. Photographs of animals are attached to some of the papers.

If you squint, you can also see a vent on the wall. Could you somehow reach that?

A single metal chair has fallen from the stack and is on the floor.

>climb onto metal chair
You can't see any such thing.

>climb chair
The vent sits frustratingly out of reach.

* * *

>n
Plaques & Papers
To the north are stacks of metal chairs and wooden slabs, golden engravings nailed into each of them. Papers with incomprehensible scrawls are scattered all over the floor. Photographs of animals are attached to some of the papers.

If you squint, you can also see a vent on the wall. Could you somehow reach that?

A single metal chair has fallen from the stack and is on the floor.

>get onto chair
You use the box as a stool to clamber onto the chair.

Plaques & Papers (on Metal chair)
The vent beckons you closer.

>go into dusty vent
You squeeze into the rusty vent, tip-toeing forward. At the end is an opening, and you carefully hop out.

Hall of Wonder

Though dark, you spy a red exit sign further north glowing softly. You make a run for it, the light getting closer...

Until you hear a faint clicking sound. Blinding and bold, a beam of light strikes you from above, and then, like a twisted domino effect, each section of the room slowly comes to life. Its enormous, the exit sign's glow now washed away by the curious sights around you.

Plants and flowers spiral up the walls of the room, inspired by the outside world. Tapestries resembling a perfect blue sky hang from the ceiling. A lion gazes into the distance, surveying its kingdom.

A hawk swoops down, talons searching for prey. A mighty moose stamps the ground, a warning to those in its way. But they are all dead, so very dead.

You can go back now or make a run north for it- either way, this isn't looking too good.

* * *

>n
Plaques & Papers
To the north are stacks of metal chairs and wooden slabs, golden engravings nailed into each of them. Papers with incomprehensible scrawls are scattered all over the floor. Photographs of animals are attached to some of the papers.

If you squint, you can also see a vent on the wall. Could you somehow reach that?

A single metal chair has fallen from the stack and is on the floor.

>n
The only way through here is a vent far out of reach.

>climb chair
You use the box as a stool to clamber onto the chair. The vent is now in reach.

plaques & papers (on Metal chair)
One chair stack is tilting so far that it could very well pass as an off-brand Leaning Tower of Pisa.

>n
The only way through here is a vent far out of reach.

>enter vent
You squeeze into the dusty vent, tip-toeing forward. At the end is an opening, and you carefully hop out.

Hall of Wonder
This new room is also dark, but you spy a red exit sign further north glowing softly. You make a run for it, the light getting closer...

Until you hear a faint clicking sound. Blinding and bold, a beam of light strikes you from above, and then, like a twisted domino effect, each section of the room slowly comes to life. Its enormous, the exit sign's glow now washed away by the curious sights around you.

Plants and flowers spiral up the walls of the room, inspired by the outside world. Tapestries resembling a perfect blue sky hang from the ceiling. A lion gazes into the distance, surveying its kingdom.

A hawk swoops down, talons searching for prey. A mighty moose stamps the ground, a warning to those in its way. But they are all dead, so very dead.

Going back would be an option if it wasn't for the sudden bang behind you signaling that the dusty vent had collapsed inwards. You have to make a run north for it..!

* * *

>n
The only way through here is a vent far out of reach.

>climb onto chair
You use the box as a stool to clamber onto the chair. The vent is now in reach.

plaques & papers (on Metal chair)
One chair stack is tilting so far that it could very well pass as an off-brand Leaning Tower of Pisa.

>climb into dusty vent
You can't see any such thing.

>enter dusty vent
You squeeze into the dusty vent, tip-toeing forward. At the end is an opening, and you carefully hop out.

Hall of Wonder
This new room is also dark, but you spy a red exit sign further north glowing softly. You make a run for it, the light getting closer...

Until you hear a faint clicking sound. Blinding and bold, a beam of light strikes you from above, and then, like a twisted domino effect, each section of the room slowly comes to life. Its enormous, the exit sign's glow now washed away by the curious sights around you.

Plants and flowers spiral up the walls of the room, inspired by the outside world. Tapestries resembling a perfect blue sky hang from the ceiling. A lion gazes into the distance, surveying its kingdom.

A hawk swoops down, talons searching for prey. A mighty moose stamps the ground, a warning to those in its way. But they are all dead, so very dead.

You can go back now or make a run north for it- either way, this isn't looking too good.

 

aa

* * *

>n
Plaques & Papers
To the north are stacks of metal chairs and wooden slabs, golden engravings nailed into each of them. Papers with incomprehensible scrawls are scattered all over the floor. Photographs of animals are attached to some of the papers.

If you squint, you can also see a vent on the wall. Could you somehow reach that?

A single metal chair has fallen from the stack and is on the floor.

>s
Darkened storage room
A heavy, constricting atmosphere surrounds you.

>w
Darkness
The room is completely dark, a low whirring of a fan its only sound.

>e
Darkened storage room
you feel uneasy and exposed.

>s
You can't go that way.

>n
plaques & papers
One chair stack is tilting so far that it could very well pass as an off-brand Leaning Tower of Pisa.

 

A single metal chair has fallen from the stack and is on the floor.

* * *

>s
The vent is completely caved in, there's no way back.

>e
You can't go that way.

>w
Bravest Who Proceed
Without wasting another second, you dash to the left, avoiding the center of the room and manuevering through the taixdermied animals, using them as protection agaist detection. They shield you from their own fate.

>w
You can't go that way.

* * *

>n
You can't go that way.

>e
You can't go that way.

* * *

>s
You can't go that way.

>e
Darkened storage room
you feel uneasy and exposed.

>w
Darkness
The room is completely dark, a low whirring of a fan its only sound.

* * *

>s
You can't go that way.

>e
Darkened storage room
A heavy, constricting atmosphere surrounds you.

>n
plaques & papers
One chair stack is tilting so far that it could very well pass as an off-brand Leaning Tower of Pisa.

 

A single metal chair has fallen from the stack and is on the floor.

* * *

>chair
You use the box as a stool to clamber onto the chair. The vent is now in reach.

plaques & papers (on Metal chair)
One chair stack is tilting so far that it could very well pass as an off-brand Leaning Tower of Pisa.

>w
(first getting off Metal chair)
You can't go that way.

>n
The only way through here is a vent far out of reach.

>s
Darkened storage room
you feel uneasy and exposed.

>e
Cases & Calamity
To the east, empty glass display cases line the wall, one of which is smashed, possibly targeted in a robbery of some sort. You stop yourself just before stepping directly into a pile of glass shards. When was this place last cleaned?

* * *

>n
You can't go that way.

>w
Darkened storage room
A heavy, constricting atmosphere surrounds you.

>s
You can't go that way.

* * *

>e
Cases & Calamity
To the east, empty glass display cases line the wall, one of which is smashed, possibly targeted in a robbery of some sort. You stop yourself just before stepping directly into a pile of glass shards. When was this place last cleaned?

>e
You can't go that way.

>s
You can't go that way.

>w
Darkened storage room
you feel uneasy and exposed.

>w
Darkness
The room is completely dark, a low whirring of a fan its only sound.

* * *

>w
You can't go that way.

>e
Darkened storage room
A heavy, constricting atmosphere surrounds you.

* * *

>climb
What do you want to climb?

>chair
You use the box as a stool to clamber onto the chair. The vent is now in reach.

plaques & papers (on Metal chair)
One chair stack is tilting so far that it could very well pass as an off-brand Leaning Tower of Pisa.

If you squint, you can also see a vent on the wall. Could you somehow reach that?

* * *

>take
(Box)
Taken.

>x
What do you want to examine?

>x darkened storage room
You can't see any such thing.

>x
What do you want to examine?

>examine figure 1
You can't see any such thing.

* * *

>take box
Taken.

>n
plaques & papers
To the north are stacks of metal chairs and wooden slabs, golden engravings nailed into each of them. Papers with incomprhensible scrawls are scattered all over the floor. Photographs of animals are attached to some of the papers

If you squint, you can also see a vent on the wall. Could you somehow reach that? 

A single metal chair has fallen from the stack and is on the floor.

>climb onto chair
You use the box as a stool to clamber onto the chair. The vent is now in reach.

plaques & papers (on Metal chair)
One chair stack is tilting so far that it could very well pass as an off-brand Leaning Tower of Pisa.

>enter dusty vent
You squeeze into the dusty vent, tip-toeing forward. At the end is an opening, and you carefully hop out.

Hall of Wonder
This new room is also dark, but you spy a red exit sign further north glowing softly. You make a run for it, the light getting closer...

Until you hear a faint clicking sound. Blinding and bold, a beam of light strikes you from above, and then, like a twisted domino effect, each section of the room slowly comes to life. Its enormous, the exit sign's glow now washed away by the curious sights around you.

Plants and flowers spiral up the walls of the room, inspired by the outside world. Tapestries resembling a perfect blue sky hang from the ceiling. A lion gazes into the distance, surveying its kingdom.

A hawk swoops down, talons searching for prey. A mighty moose stamps the ground, a warning to those in its way. But they are all dead, so very dead.

You can go back now or make a run north for it- either way, this isn't looking too good.

 

aa

>enter dusty vent
The vent sits frustratingly out of reach.

aa

* * *

>w
You can't go that way.

>s
Plaques & Papers
One chair stack is tilting so far that it could very well pass as an off-brand Leaning Tower of Pisa.

A single metal chair has fallen from the stack and is on the floor.

* * *

>n
plaques & papers
To the north are stacks of metal chairs and wooden slabs, golden engravings nailed into each of them. Papers with incomprhensible scrawls are scattered all over the floor. Photographs of animals are attached to some of the papers

If you squint, you can also see a vent on the wall. Could you somehow reach that? 

A single metal chair has fallen from the stack and is on the floor.

>n
The only way through here is a vent far out of reach.

>n
The only way through here is a vent far out of reach.

* * *

>climb chair
You use the box as a stool to clamber onto the chair. The vent is now in reach.

plaques & papers (on Metal chair)
One chair stack is tilting so far that it could very well pass as an off-brand Leaning Tower of Pisa.

>enter vent
You squeeze into the dusty vent, tip-toeing forward. At the end is an opening, and you carefully hop out.

Hall of Wonder
This new room is also dark, but you spy a red exit sign further north glowing softly. You make a run for it, the light getting closer...

Until you hear a faint clicking sound. Blinding and bold, a beam of light strikes you from above, and then, like a twisted domino effect, each section of the room slowly comes to life. Its enormous, the exit sign's glow now washed away by the curious sights around you.

Plants and flowers spiral up the walls of the room, inspired by the outside world. Tapestries resembling a perfect blue sky hang from the ceiling. A lion gazes into the distance, surveying its kingdom.

A hawk swoops down, talons searching for prey. A mighty moose stamps the ground, a warning to those in its way. But they are all dead, so very dead.

Going back would be an option if it wasn't for the sudden bang behind you signaling that the dusty vent had collapsed inwards. Going North seems like your best option, but there's a longer route westbound of the room.

>n
Ring of Fire
What you'd failed to notice, hidden among his collection, was a man.

The type of bougie guy with one of those evil villain mustaches. He's grasping a bottle of alcohol- and, glancing at you once, twice, he downs the rest of it and tosses it.

He squats down, staring like he'd seen god himself. He shakily raises his finger, the whole world stopping for a moment before he shouts,

"RABBIT!!!!!"

run, NOW!!

* * *

>take cardboard box
You can't see any such thing.

>take box
Taken.

* * *

>w
Darkness
The room is completely dark, a low whirring of a fan its only sound.

>x
()
C.

>s
You can't go that way.

* * *

>w
You can't go that way.

>e
Darkened Storage Room
A heavy, constricting atmosphere surrounds you.

>x
()
You sniff around the boxes and papers, observing cursive scrawl that you cannot understand. Photographs of animals are attached to some of the papers.

>se
You can't go that way.

>e
Cases & Calamity
To the east, empty glass display cases line the wall, one of which is smashed, possibly targeted in a robbery of some sort. You stop yourself just before stepping directly into a pile of glass shards. When was this place last cleaned?

>x
()
B.

>w
Darkened Storage Room
A heavy, constricting atmosphere surrounds you.

>n
Plaques & Papers
To the north are stacks of chairs and wooden slabs, golden engravings nailed into each of them. Papers with incomprhensible scrawls are scattered all over the floor. If you squint, you can see a vent on the wall to the north. Could you somehow reach that?

>n
You squeeze into the rusty vent, tip-toeing forward. At the end is an opening, and you carefully hop out.

Hall of Wonder

Though dark, you spy a red exit sign further north glowing softly. You make a run for it, the light getting closer...

Until you hear a faint clicking sound. Blinding and bold, a beam of light strikes you from above, and then, like a twisted domino effect, each section of the room slowly comes to life. Its enormous, the exit sign's glow now washed away by the curious sights around you.

Plants and flowers spiral up the walls of the room, inspired by the outside world. Tapestries resembling a perfect blue sky hang from the ceiling. A lion gazes into the distance, surveying its kingdom.

A hawk swoops down, talons searching for prey. A mighty moose stamps the ground, a warning to those in its way. But they are all dead, so very dead.

And in the middle of it all is a man. The type of bougie guy with one of those evil villain mustaches. He's grasping a bottle of alcohol- and, glancing at you once, twice, he downs the rest of it and tosses it.

He squats down, staring like he'd seen god himself. He shakily raises his finger, the whole world stopping for a moment before he shouts,

"RABBIT!!!!!"

run, NOW!!

>x
()
No time to look around, you need to get away!

* * *

>x
()

>x
()
You feel as if you're running out of time.

>look
Darkened Storage Room
A heavy, constricting atmosphere surrounds you.

Various boxes, small and large, are scattered about on the ground.

>take
(Box)
Taken.

>n
Plaques & Papers
To the north are stacks of metal chairs and wooden slabs, golden engravings nailed into each of them. Papers with incomprhensible scrawls are scattered all over the floor. Photographs of animals are attached to some of the papers

If you squint, you can also see a vent on the wall. Could you somehow reach that?

A single metal chair has fallen from the stack and is on the floor.

>climb chair
You use the box as a stool to clamber onto the chair. The vent is now in reach.

Plaques & Papers (on Metal chair)
One chair stack is tilting so far that it could very well pass as an off-brand Leaning Tower of Pisa.

If you squint, you can also see a vent on the wall. Could you somehow reach that?

* * *

>x
()
You feel as if you're running out of time.

>x
()
There's gotta be a way out of here.

>x
()
You look around, desperate.

* * *

>look
Darkened Storage Room
A heavy, constricting atmosphere surrounds you.

Various boxes, small and large, are scattered about on the ground.

>n
Plaques & Papers
To the north are stacks of metal chairs and wooden slabs, golden engravings nailed into each of them. Papers with incomprhensible scrawls are scattered all over the floor. Photographs of animals are attached to some of the papers

If you squint, you can also see a vent on the wall. Could you somehow reach that? 

A single metal chair has fallen from the stack and is on the floor.

>s
Darkened Storage Room
you feel uneasy and exposed.

Various boxes, small and large, are scattered about on the ground.

>take boxes
You can't see any such thing.

>take
(Box)
Taken.

* * *

>x
()

>x room
You can't see any such thing.

>examine
()
You inspect the cage floor and gently sneeze, stirring up a clump of dust in the corner of the cage. It slips through the bars effortlessly. Unbelievable.

I beg your pardon?

>n
You can't go that way.

>s
Darkened Storage Room B
To the south are stacks of wooden slabs, golden engravings nailed into each of them. Papers with incomprhensible scrawls are scattered all over the floor, looking as if they were dropped in a moment of panic.

* * *

The last thing you remember was your lush world flashing before your eyes.. how quickly times can change.

                                                                                                                                                                                                                                                                                                                               Press SPACE to begin.

>destroy loose bar with antlers.
The loose bar shatters into shimmering shards, a hole you can slip through now in its place. Wriggling your way through the hole, you quietly slink around the cage and look forward.
 
Darkened Storage Room

You now have a slightly better view of the room, and get a full idea of just how large the room is compared to you. Boxes and papers tower imposingly above. There are three sections of the room with items scattered about to the north, east, and west respectively.

>escape
You get out of the cage.

Awakening
You can see a cage (empty) here.

* * *

>destroy loose bar with antlers.
The loose bar shatters into shimmering shards, a hole you can slip through now in its place. Wriggling your way through the hole, you quietly slink around the cage and look forward.
 
Darkened Storage Room

You now have a slightly better view of the room, and get a full idea of just how large the room is compared to you. Boxes and papers tower imposingly above. There are three sections of the room with items scattered about to the north, east, and west respectively.

>n
Plaques & Papers
To the north are stacks of metal chairs and wooden slabs, golden engravings nailed into each of them. Papers with incomprhensible scrawls are scattered all over the floor. Photographs of animals are attached to some of the papers. If you squint, you can see a vent on the wall to the north. Could you somehow reach that?

One metal chair has fallen from the stack and is on the floor.

You can also see Dusty Vent (empty) here.

* * *

The last thing you remember was your lush world flashing before your eyes.. how quickly times can change.

                                                                                                                                                                                                                                                                                                                               Press SPACE to begin.

>destroy loose bar with antlers\
You can't see any such thing.

>destroy loose bar with antlers
The loose bar shatters into shimmering shards, a hole you can slip through now in its place. Wriggling your way through the hole, you quietly slink around the cage and look forward.
 
Darkened Storage Room

You now have a slightly better view of the room, and get a full idea of just how large the room is compared to you. Boxes and papers tower imposingly above. There are three sections of the room with items scattered about to the north, east, and west respectively...Tread lightly.

>n
Plaques & Papers
To the north are stacks of chairs and wooden slabs, golden engravings nailed into each of them. Papers with incomprhensible scrawls are scattered all over the floor. If you squint, you can see a vent on the wall to the north. Could you somehow reach that?

>n
You squeeze into the rusty vent, tip-toeing forward. At the end is an opening, and you carefully hop out.

Hall of Wonder

Though dark, you attempt to observe the area, spying a red exit sign further north softly glowing. It's a much-needed beacon of hope after the terror of the day. Hesitating for a moment, you make a run for it, the light getting closer,

and closer

 Until you hear a faint click echo throughout the room. Blinding and bold, a beam of light strikes you from above, and then, like a twisted domino effect, each section of the room slowly comes to life. It's enormous, the exit sign's glow now washed away by the colorful curiosities around, displayed like they would be in a museum.

For a moment, you take in the sights of the shimmering yellow light, plants and flowers spiraling up and around the walls and floor of the room seemingly inspired by the outside world. Tapestries resembling a perfect blue sky are strung from the ceiling. A lion gazes into the distance, surveying its kingdom.

 A bear rears up on its hind legs, a salmon caught in its jaws. A hawk swoops down, talons searching for prey. A mighty moose stamps the ground, a warning to those in its way. But they are dead, so very dead. 
 And in the middle of it all is a man. He's older, salt-and-pepper hair running down his back, flannel shirt loosely hanging. He's tightly grasping a bottle of alcohol- and, glancing at you once, twice, he downs the rest of it and tosses it.

Babbling in disbelief, he squats down, stance wide and staring like he'd seen god himself. He shakily raises his finger, and the whole world stops for a moment before he shouts,

"RABBIT!!!!!"

run, NOW!!"

* * *

The last thing you remember was your lush world flashing before your eyes.. how quickly times can change.

                                                                                                                                                                                                                                                                                                                               Press SPACE to begin.

>destroy loose bar with cage
The impact isn't enough to fully shatter the bar.

>destroy loose bar with antlers
The loose bar shatters into shimmering shards, a hole you can slip through now in its place. Wriggling your way through the hole, you quietly slink around the cage and look forward.
 
Darkened Storage Room

You now have a slightly better view of the room now and get a full idea of just how large the room is compared to you, boxes and furniture towering imposingly above.

>exit
You get out of the cage.

Awakening
You can see a cage (empty) here.

* * *

>destroy loose bar with cage
The impact isn't enough to fully shatter the bar.

>x me
Squinting in the darkness, you observe your small, pale wings.

>x me
You can't quite see them, but you know your antlers, though small, will go for a pretty penny in due time.

>x cage
The cage is dismal and dim, with nothig to note, unless.?

>x cage
You inspect the cage floor and gently sneeze, stirring up a clump of dust in the corner of the cage. It slips through the bars effortlessly. Unbelievable.

* * *

The last thing you remember was your lush world flashing before your eyes.. how quickly times can change.

                                                                                                                                                                                                                                                                                                                               Press SPACE to begin.

>destroy lose bar
You can't see any such thing.

>destroy loose bar
Violence isn't the answer to this one.

>take loose bar
Taken.

* * *

The last thing you remember was your lush world flashing before your eyes.. how quickly times can change.

                                                                                                                                                                                                                                                                                                                               Press SPACE to begin.

>destroy lose bar with antlers
You can't see any such thing.

>destroy loose bar with
(antlers)

The loose bar shatters into shimmering shards, a hole you can slip through now in its place. Wriggling your way through the hole, you quietly slink around the cage and look forward.
 
Darkened Storage Room

You now have a slightly better view of the room, and get a full idea of just how large the room is compared to you. Boxes and papers tower imposingly above. There are three sections of the room with items scattered about to the north, east, and west respectively. Maybe examine the floor?

>x
(antlers)
You sniff around the boxes and papers, observing cursive scrawl that you cannot understand. Photographs of animals are attached to some of the papers.

>x
(antlers)
You sniff around the boxes and papers, observing cursive scrawl that you cannot understand. Photographs of animals are attached to some of the papers.

* * *

The last thing you remember was your lush world flashing before your eyes.. how quickly times can change.

                                                                                                                                                                                                                                                                                                                               Press SPACE to begin.

>destroy the loose bar with antlers
The loose bar shatters into shimmering shards, a hole you can slip through now in its place. Now is your chance to escape!

>escape
That's not a verb I recognise.

* * *

The last thing you remember was your lush world flashing before your eyes.. how quickly times can change.

                                                                                                                                                                                                                                                                                                                               Press SPACE to begin.

>destroy the loose bar with antlers.
The loose bar shatters into shimmering shards, a hole you can slip through now in its place. Now is your chance to escape!

>escape
Wriggling your way through the hole, you quietly slink around the cage and look forward. You have a slightly better view of the room now and get a full idea of just how large the room is compared to you, boxes and furniture towering imposingly above.

* * *

The last thing you remember was your lush world flashing before your eyes.. how quickly times can change.

                                                                                                                                                                                                                                                                                                                               Press SPACE to begin.

>enter dusty vent
You can't see any such thing.

>destroy loose bar with antlers
You ram your antlers into the loose loose bar, and it shatters into shimmering shards. A hole you can slip through is now in its place. Wriggling your way through the hole, you quietly slink around the cage and look forward.
 
Darkened storage room
You now have a slightly better view of the room, and get a full idea of just how large the room is compared to you. Stacks of paper tower imposingly above. There are three sections of the room with items scattered about to the north, east, and west respectively.

Various boxes, small and large, are scattered about on the ground.

>take
(Box)
Taken.

* * *

>climb chair
You use the box as a stool to clamber onto the chair. The vent is now in reach.

plaques & papers (on Metal chair)
One chair stack is tilting so far that it could very well pass as an off-brand Leaning Tower of Pisa.

>enter dusty vent
nuh uh.

* * *

The last thing you remember was your lush world flashing before your eyes.. how quickly times can change.

                                                                                                                                                                                                                                                                                                                               Press SPACE to begin.

>estroy loose bar with antlers
That's not a verb I recognise.

>destroy loose bar with antlers
You ram your antlers into the loose loose bar, and it shatters into shimmering shards. A hole you can slip through is now in its place. Wriggling your way through the hole, you quietly slink around the cage and look forward.
 
Darkened Storage Room
You now have a slightly better view of the room, and get a full idea of just how large the room is compared to you. Stacks of paper tower imposingly above. There are three sections of the room with items scattered about to the north, east, and west respectively.

Various boxes, small and large, are scattered about on the ground.

* * *

>n
Ring of Fire
What you'd failed to notice, hidden among his collection, was a man.

He's in his pajamas (must be nice), grasping a bottle of alcohol- and, glancing at you once, twice, he downs the rest of it and tosses it.

With you now in his line of sight, he squats down, staring like he'd seen a unicorn. He shakily raises his finger, the whole world stopping for a moment before he shouts,

"RABBIT!!!!!"

run, NOW!!

>n
Exit ?
The hunter sprints after you- fast, what can you do??.

* * *

The last thing you remember was your lush world flashing before your eyes.. how quickly times can change.

                                                                                                                                                                                                                                                                                                                               Press SPACE to begin.

>go
You'll have to say which compass direction to go in.

>n
You would have to get out of Cage first.

* * *

The last thing you remember was your lush world flashing before your eyes.. how quickly times can change.

                                                                                                                                                                                                                                                                                                                               Press SPACE to begin.

>headbutt
That's not a verb I recognise.

* * *

The last thing you remember was your lush world flashing before your eyes.. how quickly times can change.

                                                                                                                                                                                                                                                                                                                               Press SPACE to begin.

>headbutt loose bar
That's not a verb I recognise.

* * *

The last thing you remember was your lush world flashing before your eyes.. how quickly times can change.

                                                                                                                                                                                                                                                                                                                               Press SPACE to begin.

>hop
You jump on the spot.

>n
You would have to get out of the cage first.

* * *

The last thing you remember was your lush world flashing before your eyes.. how quickly times can change.

                                                                                                                                                                                                                                                                                                                               Press SPACE to begin.

>kill
()
Violence isn't the answer to this one.

* * *

The last thing you remember was your lush world flashing before your eyes.. how quickly times can change.

                                                                                                                                                                                                                                                                                                                               Press SPACE to begin.

>l
Awakening (in the cage)
Never, in your whole life, has the air tasted so stale and dead.

Your body slowly acclimates to the scene. The cold, hardened ground holds you firm for a moment; both unfamiliar and hostile. This predicament- a dreadful, ironclad grip on your hammering heart- is one you've been taught to be wary of your entire life. Imprisonment in the name of corrupt glory- the kind the pursuit of wealth brings about.

Thin blades of artificial light slice through the bars of your cage. Nothing feels real- you wish it wasn't.

Almost all is silent. The unreliable ticking of a dying clock echoes through the room. There seems to be nothing here you can commit your faith to- you'll have to find your own way.

Who are you, anyways? Take a look at yourself.

>look at self
 The cage bars tower above you, the world all too large for someone your size.

* * *

The last thing you remember was your lush world flashing before your eyes.. how quickly times can change.

                                                                                                                                                                                                                                                                                                                               Press SPACE to begin.

>l self
 Squinting in the darkness, you observe your small, pale wings.

>l body part
Despite your unfortunate predicament, you know there must be a way out.

>antlers
That's not a verb I recognise.

>look at antlers
You can't see any such thing.

* * *

The last thing you remember was your lush world flashing before your eyes.. how quickly times can change.

                                                                                                                                                                                                                                                                                                                               Press SPACE to begin.

>look
Awakening (in the cage)
You inspect the cage floor and gently sneeze, stirring up a clump of dust in the corner of the cage. It slips through the bars effortlessly. Unbelievable.

>destroy loose bar with antlers
The loose bar shatters into shimmering shards, a hole you can slip through now in its place. Wriggling your way through the hole, you quietly slink around the cage and look forward.
 
eee.

* * *

>look
Awakening (in the cage)
You inspect the cage floor and gently sneeze, stirring up a clump of dust in the corner of the cage. It slips through the bars effortlessly. Unbelievable.

>l
Awakening (in the cage)

>look
Awakening (in the cage)

* * *

>look
Awakening (in the cage)
You inspect the cage floor and gently sneeze, stirring up a clump of dust in the corner of the cage. It slips through the bars effortlessly. Unbelievable.

>look
Awakening (in the cage)
As you inspect further, something catches your eye in the corner. Take a look!

>look
Is there anything in the corner? You think back to a time before all of this, fearless. You were foolish then.

* * *

>look
Awakening (in the cage)
As you inspect further, something catches your eye in the corner. Take a look!

>look at me
Squinting in the darkness, you observe your small, pale wings.

>look at corner
Oh! A loose bar catches your eye, sticking out admist the darkness. Can you destroy it with something?

>me
That's not a verb I recognise.

>look at me
You can't quite see them, but you know your antlers, though small, will go for a pretty penny in due time.

>look at me
...Your antlers are solid and sturdy, possibly useful to destroy something.

>destroy loose bar with antlers
The loose bar shatters into shimmering shards, a hole you can slip through now in its place. Wriggling your way through the hole, you quietly slink around the cage and look forward.
 
Darkened Storage Room

You now have a slightly better view of the room, and get a full idea of just how large the room is compared to you. Boxes and papers tower imposingly above. There are three sections of the room with items scattered about to the north, east, and west respectively.

>look
Darkened Storage Room
A heavy, constricting atmosphere surrounds you.

>look
Darkened Storage Room
A heavy, constricting atmosphere surrounds you.

* * *

>look
Awakening (in the cage)
As you inspect further, something catches your eye in the corner. Take a look!

>x
(the cage)
You look around, desperate.

>x
(the cage)
As you inspect further, something catches your eye in the corner.

>x me
Squinting in the darkness, you observe your small, pale wings.

* * *

>x me
You can't quite see them, but you know your antlers, though small, will go for a pretty penny in due time.

>x me
...Your antlers are solid and sturdy, possibly useful to destroy something.

>x corner
Oh! A loose bar catches your eye, sticking out admist the darkness. Can you destroy it with something?

>destroy loose bar with antlers
The loose bar shatters into shimmering shards, a hole you can slip through now in its place. Wriggling your way through the hole, you quietly slink around the cage and look forward.
 
Darkened Storage Room

You now have a slightly better view of the room, and get a full idea of just how large the room is compared to you. Boxes and papers tower imposingly above. There are three sections of the room with items scattered about to the north, east, and west respectively.

>check inventory
You can't see any such thing.

* * *

>look
Awakening (in the cage)
You inspect the cage floor and gently sneeze, stirring up a clump of dust in the corner of the cage. It slips through the bars effortlessly. Unbelievable.

>look at self
Squinting in the darkness, you observe your small, pale wings.

>destroy loose bars with antlers
I didn't understand that sentence.

>destroy loose bar with antlers
Your antlers ram into the loose loose bar, and it shatters into shimmering shards. A hole you can slip through is now in its place. Wriggling your way through the hole, you quietly slink around the cage and look forward.
 
Darkened Storage Room

You now have a slightly better view of the room, and get a full idea of just how large the room is compared to you. Boxes and papers tower imposingly above. There are three sections of the room with items scattered about to the north, east, and west respectively.

* * *

>look at self
Squinting in the darkness, you observe your small, pale wings.

>fly
That's not a verb I recognise.

>light
()
This dangerous act would achieve little.

>look
Awakening (in the cage)
As you inspect further, something catches your eye in the corner. Take a look!

>look in corner
Oh! A loose bar catches your eye, sticking out admist the darkness. Can you destroy it with something?

>grab
That's not a verb I recognise.

>look
Awakening (in the cage)
The cage is dismal and dim, with nothig to note, unless...? Look closer.

>look at self
You can't quite see them, but you know your antlers, though small, will go for a pretty penny in due time.

>ram
That's not a verb I recognise.

>destroy
( with )
The iron bars are too sturdy.

>destroy the loose bar
(with )

You ram your antlers into the loose loose bar, and it shatters into shimmering shards. A hole you can slip through is now in its place. Wriggling your way through the hole, you quietly slink around the cage and look forward.
 
Darkened storage room
You now have a slightly better view of the room, and get a full idea of just how large the room is compared to you. Stacks of paper tower imposingly above. There are three sections of the room with items scattered about to the north, east, and west respectively.

Various boxes, small and large, are scattered about on the ground.

>pick up
(Box)
Taken.

>n
plaques & papers
To the north are stacks of metal chairs and wooden slabs, golden engravings nailed into each of them. Papers with incomprhensible scrawls are scattered all over the floor. Photographs of animals are attached to some of the papers

If you squint, you can also see a vent on the wall. Could you somehow reach that? 

A single metal chair has fallen from the stack and is on the floor.

>stand on chair
You use the box as a stool to clamber onto the chair. The vent is now in reach.

plaques & papers (on Metal chair)
One chair stack is tilting so far that it could very well pass as an off-brand Leaning Tower of Pisa.

>go through vent
You squeeze into the dusty vent, tip-toeing forward. At the end is an opening, and you carefully hop out.

Hall of Wonder
This new room is also dark, but you spy a red exit sign further north glowing softly. You make a run for it, the light getting closer...

Until you hear a faint clicking sound. Blinding and bold, a beam of light strikes you from above, and then, like a twisted domino effect, each section of the room slowly comes to life. Its enormous, the exit sign's glow now washed away by the curious sights around you.

Plants and flowers spiral up the walls of the room, inspired by the outside world. Tapestries resembling a perfect blue sky hang from the ceiling. A lion gazes into the distance, surveying its kingdom.

A hawk swoops down, talons searching for prey. A mighty moose stamps the ground, a warning to those in its way. But they are all dead, so very dead.

Going back would be an option if it wasn't for the sudden bang behind you signaling that the dusty vent had collapsed inwards. Going North seems like your best option, but there's a more discreet route westbound of the room.

>go west
Bravest Who Proceed
Without wasting another second, you dash to the left, avoiding the center of the room and manuevering through the taixdermied animals, using them as protection agaist detection. They shield you from their own fate.

* * *

>look
Awakening (in the cage)
You inspect the cage floor and gently sneeze, stirring up a clump of dust in the corner of the cage. It slips through the bars effortlessly. Unbelievable.

>look cage
Despite your unfortunate predicament, you know there must be a way out.

>examine cage
You pace back and forth, contemplating.

>die
That's not a verb I recognise.

>leave cqge
I only understood you as far as wanting to leave.

>leave cage
I only understood you as far as wanting to leave.

>exit cage
I only understood you as far as wanting to exit.

>examine self
Squinting in the darkness, you observe your small, pale wings.

>examine cage
You wonder what lies outside of this barren, belittiling cage.

>examine cage
 You gently sneeze, stirring up a clump of dust in the corner of the cage. It slips through the bars effortlessly. Unbelievable.

>x wings
You can't see any such thing.

>examine self
You can't quite see them, but you know your antlers, though small, will go for a pretty penny in due time.

>x self
The cage bars tower above you, the world all too large for someone your size.

>x self
Your pelt is soft and fuzzy, though you cannot describe its true color with the little light available.

>x slef
You can't see any such thing.

>xself
That's not a verb I recognise.

>x self
...Your antlers are solid and sturdy, possibly useful to destroy something.

>use antlers on cage
That's not a verb I recognise.

>x self
Squinting in the darkness, you observe your small, pale wings.

>use antlers
That's not a verb I recognise.

>unlock cage
(with antlers)
That doesn't seem to fit the lock.

>stuff
That's not a verb I recognise.

>random stuff
I only understood you as far as wanting to random.

>f
That's not a verb I recognise.

>r
That's not a verb I recognise.

>r
That's not a verb I recognise.

>rt
That's not a verb I recognise.

>t
That's not a verb I recognise.

>tr
That's not a verb I recognise.

>f
That's not a verb I recognise.

>t
That's not a verb I recognise.

>t
That's not a verb I recognise.

>y
That was a rhetorical question.

>y
That was a rhetorical question.

* * *

>look
Awakening (in the cage)
You inspect the cage floor and gently sneeze, stirring up a clump of dust in the corner of the cage. It slips through the bars effortlessly. Unbelievable.

>n
You would have to get out of the cage first.

>e
You would have to get out of the cage first.

>s
You would have to get out of the cage first.

>w
You would have to get out of the cage first.

>t
That's not a verb I recognise.

* * *

>look
Awakening (in the cage)
You inspect the cage floor and gently sneeze, stirring up a clump of dust in the corner of the cage. It slips through the bars effortlessly. Unbelievable.

>x
(antlers)
 You think back to a time before all of this, fearless. You were foolish then.

>x
(antlers)
 You're more than this. But what part of you will be of use? Look closer.

* * *

The last thing you remember was your lush world flashing before your eyes.. how quickly times can change.

                                                                                                                                                                                                                                                                                                                               Press SPACE to begin.

>look at antlers
You look closer test.

>x antlers
You can't see any such thing.

* * *

The last thing you remember was your lush world flashing before your eyes.. how quickly times can change.

                                                                                                                                                                                                                                                                                                                               Press SPACE to begin.

>look at corner
Oh! A loose bar catches your eye, sticking out admist the darkness.

* * *

The last thing you remember was your lush world flashing before your eyes.. how quickly times can change.

                                                                                                                                                                                                                                                                                                                               Press SPACE to begin.

>look at glittering
One of the bars is askew and damaged.

* * *

The last thing you remember was your lush world flashing before your eyes.. how quickly times can change.

                                                                                                                                                                                                                                                                                                                               Press SPACE to begin.

>look at me
Squinting in the darkness, you observe yourself- a small, pale hare. You can't quite see them, but you know your antlers, though small, are very valuable.

>look at cage
You look around, desperate.

>destroy loose bar with antlers
You ram your antlers into the loose loose bar, and it shatters into shimmering shards. A hole you can slip through is now in its place. Wriggling your way through the hole, you quietly slink around the cage and look forward.
 
Darkened Storage Room
You now have a slightly better view of the room, and get a full idea of just how large the room is compared to you. Stacks of paper tower imposingly above. There are three sections of the room with items scattered about to the north, east, and west respectively.

Various boxes, small and large, are scattered about on the ground.

>x
()
As you inspect further, something catches your eye in the corner. Take a look!

* * *

The last thing you remember was your lush world flashing before your eyes.. how quickly times can change.

                                                                                                                                                                                                                                                                                                                               Press SPACE to begin.

>look at myself
You must supply a noun.

* * *

The last thing you remember was your lush world flashing before your eyes.. how quickly times can change.

                                                                                                                                                                                                                                                                                                                               Press SPACE to begin.

>look at self
 you are soft. .

* * *

The last thing you remember was your lush world flashing before your eyes.. how quickly times can change.

                                                                                                                                                                                                                                                                                                                               Press SPACE to begin.

>look in corner
Oh! A loose bar catches your eye, sticking out admist the darkness.

>x me
Squinting in the darkness, you observe your small, pale wings.

* * *

>x me
You can't quite see them, but you know your antlers, though small, will go for a pretty penny in due time.

>x me
The cage bars tower above you, the world all too large for someone your size.

>x me
Your pelt is soft and fuzzy, though you cannot describe its true color with the little light available.

>x me
...Your antlers are solid and sturdy, possibly useful.

>x me
Squinting in the darkness, you observe your small, pale wings.

* * *

>x me
You can't quite see them, but you know your antlers, though small, will go for a pretty penny in due time.

>x room
You can't see any such thing.

* * *

The last thing you remember was your lush world flashing before your eyes.. how quickly times can change.

                                                                                                                                                                                                                                                                                                                               Press SPACE to begin.

>look in the corner
Oh! A loose bar catches your eye, sticking out admist the darkness. Can you destroy it with something?

>look at me
Squinting in the darkness, you observe your small, pale wings.

>look at me
You can't quite see them, but you know your antlers, though small, will go for a pretty penny in due time.

>look at antlers
You think more about your antlers. They're hard enough to leave a dent in something. But where?

>antlers
You think more about your antlers. They're hard enough to leave a dent in something. But where?

>destroy
(antlers with antlers)
The impact isn't enough to fully shatter the bars.

>destroy loose
(with antlers)

The loose bar shatters into shimmering shards, a hole you can slip through now in its place. Wriggling your way through the hole, you quietly slink around the cage and look forward.
 
Darkened Storage Room

You now have a slightly better view of the room, and get a full idea of just how large the room is compared to you. Boxes and papers tower imposingly above. There are three sections of the room with items scattered about to the north, east, and west respectively.

>x
(antlers)
You sniff around the boxes and papers, observing cursive scrawl that you cannot understand. Photographs of animals are attached to some of the papers.

* * *

The last thing you remember was your lush world flashing before your eyes.. how quickly times can change.

                                                                                                                                                                                                                                                                                                                               Press SPACE to begin.

>looking
You must supply a noun.

* * *

The last thing you remember was your lush world flashing before your eyes.. how quickly times can change.

                                                                                                                                                                                                                                                                                                                               Press SPACE to begin.

>me
It's you alright.

>destroy loose bar with antlers
The loose bar shatters into shimmering shards, a hole you can slip through now in its place. Now is your chance to escape!

>escape
 Wriggling your way through the hole, you quietly slink around the cage and look forward. You have a slightly better view of the room now and get a full idea of just how large the room is compared to you, boxes and furniture towering imposingly above

* * *

The last thing you remember was your lush world flashing before your eyes.. how quickly times can change.

                                                                                                                                                                                                                                                                                                                               Press SPACE to begin.

>n
You would have to get out of the cage first.

>destroy loose bar with antlers
The loose bar shatters into shimmering shards, a hole you can slip through now in its place. Wriggling your way through the hole, you quietly slink around the cage and look forward.
 
Darkened Storage Room

You now have a slightly better view of the room, and get a full idea of just how large the room is compared to you. Boxes and papers tower imposingly above. There are three sections of the room with items scattered about to the north, east, and west respectively...Tread lightly.

* * *

>n
Plaques & Papers
To the north are stacks of chairs and wooden slabs, golden engravings nailed into each of them. Papers with incomprhensible scrawls are scattered all over the floor. If you squint, you can see a vent on the wall to the north. Could you somehow reach that?

>n
You squeeze into the rusty vent, tip-toeing forward. At the end is an opening, and you carefully hop out.

Hall of Wonder

Though dark, you attempt to observe the area, spying a red exit sign further north softly glowing. Hesitating for a moment, you make a run for it, its light getting closer,

and closer

Until you hear a faint click echo throughout the room. Blinding and bold, a beam of light strikes you from above, and then, like a twisted domino effect, each section of the room slowly comes to life. It's enormous, the exit sign's glow now washed away by the colorful curiosities displayed around,.

You momentarily take in the sights of the shimmering yellow light, plants and flowers spiraling up and around the walls of the room, inspired by the outside world. Tapestries resembling a perfect blue sky hang from the ceiling. A lion gazes into the distance, surveying its kingdom.

A bear rears up on its hind legs, a salmon in its jaws. A hawk swoops down, talons searching for prey. A mighty moose stamps the ground, a warning to those in its way. But they are dead, so very dead.

And in the middle of it all is a man. He's older, salt-and-pepper hair running down his neck, flannel shirt loosely hanging. He's grasping a bottle of alcohol- and, glancing at you once, twice, he downs the rest of it and tosses it.

He squats down, stance wide and staring like he'd seen god himself. He shakily raises his finger, the whole world stopping for a moment before he shouts, 
 "RABBIT!!!!!"

run, NOW!!

* * *

>n
You would have to get out of the cage first.

>hop
You jump on the spot.

* * *

>n
You would have to get out of the cage first.

>look
Awakening (in the cage)
Never, in your whole life, has the air tasted so stale and dead.

Your body slowly acclimates to the scene. The cold, hardened ground holds you firm for a moment; both unfamiliar and hostile. This predicament- a dreadful, ironclad grip on your hammering heart- is one you've been taught to be wary of your entire life. Imprisonment in the name of corrupt glory- the kind the pursuit of wealth brings about.

Thin blades of artificial light slice through the bars of your cage. Nothing feels real- you wish it wasn't.

Almost all is silent. The unreliable ticking of a dying clock echoes through the room. There seems to be nothing here you can commit your faith to- you'll have to find your own way.

Who are you, anyways? Take a look at youtself.

* * *

>n
You would have to get out of the cage first.

>s
You would have to get out of the cage first.

* * *

>w
You would have to get out of the cage first.

>e
You would have to get out of the cage first.

* * *

The last thing you remember was your lush world flashing before your eyes.. how quickly times can change.

                                                                                                                                                                                                                                                                                                                               Press SPACE to begin.

>now the cage is unlocked;
That's not a verb I recognise.

* * *

The last thing you remember was your lush world flashing before your eyes.. how quickly times can change.

                                                                                                                                                                                                                                                                                                                               Press SPACE to begin.

>observe
A murky grayness stares back at you. If you focus hard enough, you can make out various shapes, boxes and tools littering the floor outside of the cage. Everything beyond is enveloped in darkness. To you, an escape would be more akin to a marathon- but, the only way is through.

>x
(the cage)
Despite your unfortunate predicament, you know there must be a way out.

>x me
 Squinting in the darkness, you observe your small, pale wings.

>x me
 You can't quite see them, but you know your antlers, though small, will go for a pretty penny in due time.

>x me
 The cage bars tower above you, the world all too large for someone your size.

>x antler
You think more about your antlers. They're hard enough to leave a dent in something. But where?

>scream
 With all your might, you scream and cry out- that is, until you hear footsteps shuffling near. You've never been silenced fast in your life.

>sleep
You curl up in the corner of the cage, but you can't sleep like this- not with your heart pounding; precious minutes slipping away.

>look
Awakening (in the cage)

* * *

The last thing you remember was your lush world flashing before your eyes.. how quickly times can change.

                                                                                                                                                                                                                                                                                                                               Press SPACE to begin.

>play
()

>play the sound of introduction
You can't see any such thing.

>play sound of introduction
You can't see any such thing.

>destroy loose bar with antlers
You ram your antlers into the loose loose bar, and it shatters into shimmering shards. A hole you can slip through is now in its place. Wriggling your way through the hole, you quietly slink around the cage and look forward.
 
Darkened Storage Room
You now have a slightly better view of the room, and get a full idea of just how large the room is compared to you. Stacks of paper tower imposingly above. There are three sections of the room with items scattered about to the north, east, and west respectively.

Various boxes, small and large, are scattered about on the ground.

* * *

>take
(Box)
Taken.

>s
You can't go that way.

* * *

>w
Darkness
The room is completely dark, a low whirring of a fan its only sound.

>e
Darkened Storage Room
A heavy, constricting atmosphere surrounds you.

>w
Darkness
The room is completely dark, a low whirring of a fan its only sound.

* * *

>s
You can't go that way.

>e
Darkened Storage Room
you feel uneasy and exposed.

>e
Cases & Calamity
To the east, empty glass display cases line the wall, one of which is smashed, possibly targeted in a robbery of some sort. You stop yourself just before stepping directly into a pile of glass shards. When was this place last cleaned?

* * *

The last thing you remember was your lush world flashing before your eyes.. how quickly times can change.

                                                                                                                                                                                                                                                                                                                               Press SPACE to begin.

>sleep
You curl up in the corner of the cage, but you can't sleep like this- not with your heart pounding; precious minutes slipping away.

* * *

The last thing you remember was your lush world flashing before your eyes.. how quickly times can change.

                                                                                                                                                                                                                                                                                                                               Press SPACE to begin.

>stand on
()
That's not something you can stand on.

>stand on chair
You can't see any such thing.

>stand on metal chair
You can't see any such thing.

>destroy loose bar
(with )

Your antlers ram into the loose loose bar, and it shatters into shimmering shards. A hole you can slip through is now in its place. Wriggling your way through the hole, you quietly slink around the cage and look forward.
 
Darkened Storage Room

You now have a slightly better view of the room, and get a full idea of just how large the room is compared to you. Boxes and papers tower imposingly above. There are three sections of the room with items scattered about to the north, east, and west respectively.

>n
Plaques & Papers
To the north are stacks of metal chairs and wooden slabs, golden engravings nailed into each of them. Papers with incomprhensible scrawls are scattered all over the floor. Photographs of animals are attached to some of the papers

One metal chair has fallen from the stack and is on the floor.

If you squint, you can also see a vent on the wall. Could you somehow reach that?

>stand on metal chair
That's not something you can stand on.

* * *

The last thing you remember was your lush world flashing before your eyes.. how quickly times can change.

                                                                                                                                                                                                                                                                                                                               Press SPACE to begin.

>take loose bar
That's fixed in place.

>x self
 Squinting in the darkness, you observe your small, pale wings.

>x me
 You can't quite see them, but you know your antlers, though small, will go for a pretty penny in due time.

* * *

The last thing you remember was your lush world flashing before your eyes.. how quickly times can change.

                                                                                                                                                                                                                                                                                                                               Press SPACE to begin.

>wear antlers
You can't see any such thing.

>antlers
That's not a verb I recognise.

>take antlers
You can't see any such thing.

* * *

The last thing you remember was your lush world flashing before your eyes.. how quickly times can change.

                                                                                                                                                                                                                                                                                                                               Press SPACE to begin.

>where
I've seen glimpses of what lies beyond, but nothing intricate enough to give you an answer.

>who
That's not a verb I recognise.

* * *

The last thing you remember was your lush world flashing before your eyes.. how quickly times can change.

                                                                                                                                                                                                                                                                                                                               Press SPACE to begin.

>wherre
That's not a verb I recognise.

>where
I've forgotten at this point.

>why
A question I wish I knew the answer to. I asked the same in cycles of cynicism. It won't do you any good.

* * *

The last thing you remember was your lush world flashing before your eyes.. how quickly times can change.

                                                                                                                                                                                                                                                                                                                               Press SPACE to begin.

>who
Well, you are you. Who else would you be?

>where
I've seen glimpses of what lies beyond, but nothing intricate enough to give you an answer.

* * *

>who
Well, you are you. Who else would you be?

>why
A question I wish I knew the answer to. Maybe we were bound by fate. You'll be free. You will.

* * *

The last thing you remember was your lush world flashing before your eyes.. how quickly times can change.

                                                                                                                                                                                                                                                                                                                               Press SPACE to begin.

>why
That's not a verb I recognise.

* * *

The last thing you remember was your lush world flashing before your eyes.. how quickly times can change.

                                                                                                                                                                                                                                                                                                                               Press SPACE to begin.

>x
(the cage)
You look around, desperate.

>destroy loose bar with antlers
The loose bar shatters into shimmering shards, a hole you can slip through now in its place. Wriggling your way through the hole, you quietly slink around the cage and look forward.
 
Darkened Storage Room

You now have a slightly better view of the room, and get a full idea of just how large the room is compared to you. Boxes and papers tower imposingly above. There are three sections of the room with items scattered about to the north, east, and west respectively. Maybe examine the floor?

>n
Plaques & Papers
To the north are stacks of chairs and wooden slabs, golden engravings nailed into each of them. Papers with incomprhensible scrawls are scattered all over the floor. If you squint, you can see a vent on the wall to the north. Could you somehow reach that?

>n
You squeeze into the rusty vent, tip-toeing forward. At the end is an opening, and you carefully hop out.

Hall of Wonder

Though dark, you attempt to observe the area, spying a red exit sign further north softly glowing. It's a much-needed beacon of hope after the terror of the day. Hesitating for a moment, you make a run for it, the light getting closer,

and closer

Until you hear a faint click echo throughout the room. Blinding and bold, a beam of light strikes you from above, and then, like a twisted domino effect, each section of the room slowly comes to life. It's enormous, the exit sign's glow now washed away by the colorful curiosities around, displayed like they would be in a museum.

For a moment, you take in the sights of the shimmering yellow light, plants and flowers spiraling up and around the walls and floor of the room seemingly inspired by the outside world. Tapestries resembling a perfect blue sky are strung from the ceiling. A lion gazes into the distance, surveying its kingdom.

A bear rears up on its hind legs, a salmon caught in its jaws. A hawk swoops down, talons searching for prey. A mighty moose stamps the ground, a warning to those in its way. But they are dead, so very dead. 
 And in the middle of it all is a man. He's older, salt-and-pepper hair running down his back, flannel shirt loosely hanging. He's tightly grasping a bottle of alcohol- and, glancing at you once, twice, he downs the rest of it and tosses it.

Babbling in disbelief, he squats down, stance wide and staring like he'd seen god himself. He shakily raises his finger, and the whole world stops for a moment before he shouts,

"RABBIT!!!!!"

run, NOW!!

* * *

>destroy loose bar with antlers
The loose bar shatters into shimmering shards, a hole you can slip through now in its place. Wriggling your way through the hole, you quietly slink around the cage and look forward.
 
Darkened Storage Room

You now have a slightly better view of the room, and get a full idea of just how large the room is compared to you. Boxes and papers tower imposingly above. There are three sections of the room with items scattered about to the north, east, and west respectively. Maybe examine the floor?

>x
()
You sniff around the boxes and papers, observing cursive scrawl that you cannot understand. Photographs of animals are attached to some of the papers.

* * *

>x
(the cage)
You look around, desperate.

>look
Awakening (in the cage)
You inspect the cage floor and gently sneeze, stirring up a clump of dust in the corner of the cage. It slips through the bars effortlessly. Unbelievable.

* * *

>look
Awakening (in the cage)
As you inspect further, something catches your eye in the corner. Take a look!

>destroy loose bar with antlers
You ram your antlers into the loose loose bar, and it shatters into shimmering shards. A hole you can slip through is now in its place. Wriggling your way through the hole, you quietly slink around the cage and look forward.
 
Darkened storage room
You now have a slightly better view of the room, and get a full idea of just how large the room is compared to you. Stacks of paper tower imposingly above. There are three sections of the room with items scattered about to the north, east, and west respectively.

Various boxes, small and large, are scattered about on the ground.

>inventory
You are carrying:
  Your trusty antlers (being worn)

>n
Plaques & Papers
To the north are stacks of metal chairs and wooden slabs, golden engravings nailed into each of them. Papers with incomprhensible scrawls are scattered all over the floor. Photographs of animals are attached to some of the papers

One metal chair has fallen from the stack and is on the floor.

If you squint, you can also see a vent on the wall. Could you somehow reach that?

* * *

>s
(first getting off Metal chair)

Darkened storage room
A heavy, constricting atmosphere surrounds you 

Various boxes, small and large, are scattered about on the ground.

>take
(Box)
Taken.

>n
Plaques & Papers
The vent beckons you closer.

One metal chair has fallen from the stack and is on the floor.

* * *

>look
Awakening (in the cage)
You inspect the cage floor and gently sneeze, stirring up a clump of dust in the corner of the cage. It slips through the bars effortlessly. Unbelievable.

>look at me
Squinting in the darkness, you observe your small, pale wings.

>look at cage
As you inspect further, something catches your eye in the corner.

* * *

>look
Awakening (in the cage)
You inspect the cage floor and gently sneeze, stirring up a clump of dust in the corner of the cage. It slips through the bars effortlessly. Unbelievable.

>look at self
 The cage bars tower above you, the world all too large for someone your size.

>x self
 Your antlers, though small, will go for a pretty penny in due time.

* * *

>look
Awakening (in the cage)
You inspect the cage floor and gently sneeze, stirring up a clump of dust in the corner of the cage. It slips through the bars effortlessly. Unbelievable.

>x
(the cage)
You pace back and forth, contemplating.

* * *

>look
Awakening (in the cage)
You inspect the cage floor and gently sneeze, stirring up a clump of dust in the corner of the cage. It slips through the bars effortlessly. Unbelievable.

>x me
You inspect the cage floor and gently sneeze, stirring up a clump of dust in the corner of the cage. It slips through the bars effortlessly. Unbelievable.

>x me
As you inspect further, something catches your eye in the corner.

>x me
The cage is dismal and dim, with nothig to note, unless...? Look closer.

>destroy loose bar with
(antlers)

The loose bar shatters into shimmering shards, a hole you can slip through now in its place. Wriggling your way through the hole, you quietly slink around the cage and look forward.
 
Darkened Storage Room

You now have a slightly better view of the room, and get a full idea of just how large the room is compared to you. Boxes and papers tower imposingly above. There are three sections of the room with items scattered about to the north, east, and west respectively. Maybe examine the floor?

* * *

>x
(antlers)
You sniff around the boxes and papers, observing cursive scrawl that you cannot understand. Photographs of animals are attached to some of the papers.

>look
Darkened Storage Room
A heavy, constricting atmosphere surrounds you.

>x
(antlers)
You sniff around the boxes and papers, observing cursive scrawl that you cannot understand. Photographs of animals are attached to some of the papers.

>n
Plaques & Papers
To the north are stacks of chairs and wooden slabs, golden engravings nailed into each of them. Papers with incomprhensible scrawls are scattered all over the floor. If you squint, you can see a vent on the wall to the north. Could you somehow reach that?

>x
(antlers)
A.

>who
Well, you are you. Who else would you be?

>look
Plaques & Papers
To the north are stacks of chairs and wooden slabs, golden engravings nailed into each of them. Papers with incomprhensible scrawls are scattered all over the floor. If you squint, you can see a vent on the wall to the north. Could you somehow reach that?

* * *

>look
Awakening (in the cage)
You inspect the cage floor and gently sneeze, stirring up a clump of dust in the corner of the cage. It slips through the bars effortlessly. Unbelievable.

>x self
you are soft.

* * *

>x
(the cage)
You look around, desperate.

>me
That's not a verb I recognise.

* * *

>x
(the cage)
You look around, desperate.

>x
(the cage)
As you inspect further, something catches your eye in the corner. Take a look!

>destroy loose bar with antlers
The loose bar shatters into shimmering shards, a hole you can slip through now in its place. Wriggling your way through the hole, you quietly slink around the cage and look forward.
 
Darkened Storage Room

You now have a slightly better view of the room, and get a full idea of just how large the room is compared to you. Boxes and papers tower imposingly above. There are three sections of the room with items scattered about to the north, east, and west respectively...Tread lightly.

>x
()
You see nothing special about .

* * *

>x
(the cage)
As you inspect further, something catches your eye in the corner. Take a look!

>look
Awakening (in the cage)
You inspect the cage floor and gently sneeze, stirring up a clump of dust in the corner of the cage. It slips through the bars effortlessly. Unbelievable.

>loo
That's not a verb I recognise.

>look
Awakening (in the cage)
As you inspect further, something catches your eye in the corner.

>look
Awakening (in the cage)
The cage is dismal and dim, with nothig to note, unless...? Look closer.

>look
Awakening (in the cage)
You inspect the cage floor and gently sneeze, stirring up a clump of dust in the corner of the cage. It slips through the bars effortlessly. Unbelievable.

* * *

>look at me
...Your antlers are solid and sturdy, possibly useful to destroy something.

>look in the corner
You can't see any such thing.

* * *

>look at me
Squinting in the darkness, you observe your small, pale wings.

>destroy loose bar with antlers
You ram your antlers into the loose loose bar, and it shatters into shimmering shards. A hole you can slip through is now in its place. Wriggling your way through the hole, you quietly slink around the cage and look forward.
 
darkened storage room
You now have a slightly better view of the room, and get a full idea of just how large the room is compared to you. Boxes and papers tower imposingly above. There are three sections of the room with items scattered about to the north, east, and west respectively.

You can see Carboard box here.

>x
()
You look around, desperate.

>n
Plaques & Papers
To the north are stacks of metal chairs and wooden slabs, golden engravings nailed into each of them. Papers with incomprhensible scrawls are scattered all over the floor. Photographs of animals are attached to some of the papers

One metal chair has fallen from the stack and is on the floor.

If you squint, you can also see a vent on the wall. Could you somehow reach that?

>climb onto chair
You can't see any such thing.

>get onto chair
The chair is too tall to climb onto

>s
darkened storage room
A heavy, constricting atmosphere surrounds you 

You can see Carboard box here.

>take cardboard box
You can't see any such thing.

* * *

>look
Awakening (in the cage)
You inspect the cage floor and gently sneeze, stirring up a clump of dust in the corner of the cage. It slips through the bars effortlessly. Unbelievable.

>x
()
As you inspect further, something catches your eye in the corner.

* * *

>x
(the cage)
As you inspect further, something catches your eye in the corner. Take a look!

>x
(the cage)
You inspect the cage floor and gently sneeze, stirring up a clump of dust in the corner of the cage. It slips through the bars effortlessly. Unbelievable.

>me
It's you alright.

>x  me
Squinting in the darkness, you observe your small, pale wings.

* * *

>x
(the cage)
You inspect the cage floor and gently sneeze, stirring up a clump of dust in the corner of the cage. It slips through the bars effortlessly. Unbelievable.

>look
Awakening (in the cage)

* * *

>x
(the cage)
You inspect the cage floor and gently sneeze, stirring up a clump of dust in the corner of the cage. It slips through the bars effortlessly. Unbelievable.

>x
()
The cage is dismal and dim, with nothig to note, unless...? Look closer.

>take loose bar
You can't see any such thing.

* * *

>x
()
The cage is dismal and dim, with nothig to note, unless...? Look closer.

>x
(the cage)
 You think back to a time before all of this, fearless. You were foolish then.

>x
(the cage)
 You're more than this. But what part of you will be of use? Look closer.

>x
(the cage)
 Something clatters to the floor rooms ahead.

>x
(the cage)
 Isn't this getting old?

I beg your pardon?

>x
(the cage)
Despite your unfortunate predicament, you know there must be a way out.

* * *

>x
(the cage)
 Isn't this getting old?

>x
(the cage)
Despite your unfortunate predicament, you know there must be a way out.

>x
(the cage)
You pace back and forth, contemplating.

Something glitters in the corner.

>x
(the cage)
 Isn't this getting old?

>x
(the cage)
You pace back and forth, contemplating.

>x
(the cage)
 You gently sneeze, stirring up a clump of dust in the corner of the cage. It slips through the bars effortlessly. Unbelievable.

>x
(the cage)
 You think back to a time before all of this, fearless. You were foolish then.

>x
(the cage)
 Something clatters to the floor rooms ahead.

>x
(the cage)
Despite your unfortunate predicament, you know there must be a way out.

>x
(the cage)
 Isn't this getting old?

* * *

>x
(the cage)
You pace back and forth, contemplating.

>x
(the cage)
 You think back to a time before all of this, fearless. You were foolish then.

>x
(the cage)
 You gently sneeze, stirring up a clump of dust in the corner of the cage. It slips through the bars effortlessly. Unbelievable.

>take loose bar
You can't see any such thing.

>x
(the cage)
 You gently sneeze, stirring up a clump of dust in the corner of the cage. It slips through the bars effortlessly. Unbelievable.

>x self
 Oh! you have small, white wings.

>x self
 Your antlers, though small, will go for a pretty penny in due time.

>x self
 Your antlers, though small, will go for a pretty penny in due time.

>x sel
You can't see any such thing.

>x self
 The cage bars tower above you, the world all too large for someone your size.

>x self
 The cage bars tower above you, the world all too large for someone your size.

* * *

>x
(the cage)
 You gently sneeze, stirring up a clump of dust in the corner of the cage. It slips through the bars effortlessly. Unbelievable.

>x
(the cage)
 Isn't this getting old?

* * *

>x
(the cage)
You pace back and forth, contemplating.

>x
(the cage)
Despite your unfortunate predicament, you know there must be a way out.

>x
(the cage)
Despite your unfortunate predicament, you know there must be a way out.

>x
(the cage)
You pace back and forth, contemplating.

>x
(the cage)
You pace back and forth, contemplating.

>x
(the cage)
You wonder what lies outside of this barren, belittiling cage.

>x
(the cage)
Despite your unfortunate predicament, you know there must be a way out.

* * *

>x
(the cage)
You pace back and forth, contemplating.

>x
(the cage)
 You gently sneeze, stirring up a clump of dust in the corner of the cage.

>x
(the cage)
 You gently sneeze, stirring up a clump of dust in the corner of the cage.

>x
(the cage)

>x
(the cage)
You wonder what lies outside of this barren, belittiling cage.

* * *

>x
(the cage)
Despite your unfortunate predicament, you know there must be a way out.

>x me
 Squinting in the darkness, you observe your small, pale wings. 
...Something glitters in the corner.

>x me
 Your antlers, though small, will go for a pretty penny in due time.

>x me
 The cage bars tower above you, the world all too large for someone your size.

>x me
 Your pelt is soft and fuzzy, though you cannot describe its true color with the little light available.

>x me
 ...Your antlers are solid and sturdy, possibly useful.

>x me
 Squinting in the darkness, you observe your small, pale wings.

>x me
 Your antlers, though small, will go for a pretty penny in due time.

* * *

>x
(the cage)
 You're more than this. But what part of you will be of use? Look closer.

>x sel
You can't see any such thing.

>x self
 The cage bars tower above you, the world all too large for someone your size.
testtt

* * *

>x
()
The cage is dismal and dim, with nothig to note, unless...? Look closer.

>x corner
You can't see any such thing.

* * *

>x
(the cage)
You inspect the cage floor and gently sneeze, stirring up a clump of dust in the corner of the cage. It slips through the bars effortlessly. Unbelievable.

>x yourself
You can't see any such thing.

>x player
You can't see any such thing.

>x self
 The cage bars tower above you, the world all too large for someone your size.

* * *

>x
(the cage)
As you inspect further, something catches your eye in the corner. Take a look!

>x me
Squinting in the darkness, you observe your small, pale wings.

* * *

>x
(the cage)
You look around, desperate.

>x cage
 You think back to a time before all of this, fearless. You were foolish then.

>x cage
..Something catches your eye in the corner.

>x me
Squinting in the darkness, you observe your small, pale wings.

* * *

>x me
You can't quite see them, but you know your antlers, though small, will go for a pretty penny in due time.

>xme
That's not a verb I recognise.

>look at corner
Oh! A loose bar catches your eye, sticking out admist the darkness. Can you destroy it with something?

...Something glitters in the corner.

* * *

>x
(the cage)
You look around, desperate.

>x loose bar
You pace back and forth, contemplating.

* * *

>x
(the cage)
You look around, desperate.

>x me
Squinting in the darkness, you observe your small, pale wings.

>examine cage
You inspect the cage floor and gently sneeze, stirring up a clump of dust in the corner of the cage. It slips through the bars effortlessly. Unbelievable.

>examine me
You can't quite see them, but you know your antlers, though small, will go for a pretty penny in due time.

>look at me
...Your antlers are solid and sturdy, possibly useful to destroy something.

>look at cage
As you inspect further, something catches your eye in the corner.

* * *

>x me
Squinting in the darkness, you observe your small, pale wings.

>x
(the cage)
You pace back and forth, contemplating.

>x me
 Your antlers, though small, will go for a pretty penny in due time.

* * *

>x
(the cage)
You look around, desperate.

>x outside
A murky grayness stares back at you. If you focus hard enough, you can make out various shapes, boxes and tools littering the floor outside of the cage. Everything beyond is enveloped in darkness. To you, an escape would be more akin to a marathon- but, the only way is through.

* * *

>x
(the cage)
You look around, desperate.

>x self
 Oh! you have small, white wings.

>x self
 Oh! you have small, white wings.

>x self
 The cage bars tower above you, the world all too large for someone your size.

>x self
 Your antlers, though small, will go for a pretty penny in due time.

>x self
 Oh! you have small, white wings.

* * *

The last thing you remember was your lush world flashing before your eyes.. how quickly times can change.

                                                                                                                                                                                                                                                                                                                               Press SPACE to begin.

>x antler
You think more about your antlers. They're hard enough to leave a dent in something. But where?

* * *

The last thing you remember was your lush world flashing before your eyes.. how quickly times can change.

                                                                                                                                                                                                                                                                                                                               Press SPACE to begin.

>x antlers
You can't see any such thing.

>antlers
You must supply a noun.

>look at antlers
You must supply a noun.

* * *

>x antlers
You can't see any such thing.

>x me
 Squinting in the darkness, you observe your small, pale wings.

* * *

>x antlers
You can't see any such thing.

>x myself
 Squinting in the darkness, you observe your small, pale wings.

* * *

The last thing you remember was your lush world flashing before your eyes.. how quickly times can change.

                                                                                                                                                                                                                                                                                                                               Press SPACE to begin.

>x cage
The cage is dismal and dim, with nothig to note, unless...? Look closer.

>x cage
You pace back and forth, contemplating.

..

>x cage
You wonder what lies outside of this barren, belittiling cage.

.....

>x cage
 You gently sneeze, stirring up a clump of dust in the corner of the cage. It slips through the bars effortlessly. Unbelievable. 
..

>x cage
 You think back to a time before all of this, fearless. You were foolish then. 
...

>x cage
 You're more than this. But what part of you will be of use? Look closer. 
...

>x cage
 Something clatters to the floor rooms ahead. 
.......

* * *

>x cage
The cage is dismal and dim, with nothig to note, unless...? Look closer.

>x me
You inspect the cage floor and gently sneeze, stirring up a clump of dust in the corner of the cage. It slips through the bars effortlessly. Unbelievable.

* * *

The last thing you remember was your lush world flashing before your eyes.. how quickly times can change.

                                                                                                                                                                                                                                                                                                                               Press SPACE to begin.

>x corner
Oh! A loose bar catches your eye, sticking out admist the darkness. Can you destroy it with something?

>destroy loose bar with antlers
The loose bar shatters into shimmering shards, a hole you can slip through now in its place. Wriggling your way through the hole, you quietly slink around the cage and look forward.
 
Darkened Storage Room

You now have a slightly better view of the room, and get a full idea of just how large the room is compared to you. Boxes and papers tower imposingly above... Tread lightly.

>x
()
The cage is dismal and dim, with nothig to note, unless...? Look closer.

>x room
You can't see any such thing.

* * *

>x corner
Oh! A loose bar catches your eye, sticking out admist the darkness. Can you destroy it with something?

>x me
You inspect the cage floor and gently sneeze, stirring up a clump of dust in the corner of the cage. It slips through the bars effortlessly. Unbelievable.

* * *

>x me
As you inspect further, something catches your eye in the corner.

>x myself
You inspect the cage floor and gently sneeze, stirring up a clump of dust in the corner of the cage. It slips through the bars effortlessly. Unbelievable.

>x player
You can't see any such thing.

* * *

The last thing you remember was your lush world flashing before your eyes.. how quickly times can change.

                                                                                                                                                                                                                                                                                                                               Press SPACE to begin.

>x loose bar
test...

>x me
 Your antlers, though small, will go for a pretty penny in due time.

>x loose bar
It's slightly askew and looks loose. Maybe a hard hit could break it?

* * *

The last thing you remember was your lush world flashing before your eyes.. how quickly times can change.

                                                                                                                                                                                                                                                                                                                               Press SPACE to begin.

>x me
Squinting in the darkness, you observe yourself- a small, pale hare. You can't quite see them, but you know your antlers, though small, are very valuable.

>destroy loose bar with antlers
You ram your antlers into the loose loose bar, and it shatters into shimmering shards. A hole you can slip through is now in its place. Wriggling your way through the hole, you quietly slink around the cage and look forward.
 
darkened storage room
You now have a slightly better view of the room, and get a full idea of just how large the room is compared to you. Stacks of paper tower imposingly above. There are three sections of the room with items scattered about to the north, east, and west respectively.

You can see Carboard box here.

>n
Plaques & Papers
To the north are stacks of metal chairs and wooden slabs, golden engravings nailed into each of them. Papers with incomprhensible scrawls are scattered all over the floor. Photographs of animals are attached to some of the papers. If you squint, you can see a vent on the wall to the north. Could you somehow reach that?

test.

* * *

>x me
Squinting in the darkness, you observe yourself- a small, pale hare. You can't quite see them, but you know your antlers, though small, are very valuable.

>look
Awakening (in the cage)
You inspect the cage floor and gently sneeze, stirring up a clump of dust in the corner of the cage. It slips through the bars effortlessly. Unbelievable.

>examine cage
In the cage is loose bar.

>x
(the cage)
In the cage is loose bar.

* * *

>look
Awakening (in the cage)
You inspect the cage floor and gently sneeze, stirring up a clump of dust in the corner of the cage. It slips through the bars effortlessly. Unbelievable.

>look
Awakening (in the cage)
As you inspect further, something catches your eye in the corner.

* * *

>x me
Squinting in the darkness, you observe yourself- a small, pale hare. You can't quite see them, but you know your antlers, though small, are very valuable.

>look at myself
You can't quite see them, but you know your antlers, though small, will go for a pretty penny in due time.

* * *

>x me
Squinting in the darkness, you observe yourself- a small, pale hare. You can't quite see them, but you know your antlers, though small, are very valuable.

>x
(the cage)
Despite your unfortunate predicament, you know there must be a way out.

* * *

>x
(the cage)
You wonder what lies outside of this barren, belittiling cage.

>x
(the cage)
 You gently sneeze, stirring up a clump of dust in the corner of the cage. It slips through the bars effortlessly. Unbelievable.

* * *

>x me
Squinting in the darkness, you observe yourself- a small, pale hare. You can't quite see them, but you know your antlers, though small, are very valuable.

>x antlers
You think more about your antlers. They're hard enough to leave a dent in something. But where?

>x me
You can't quite see them, but you know your antlers, though small, will go for a pretty penny in due time.

>x cage
You look around, desperate.

* * *

>x me
Squinting in the darkness, you observe yourself- a small, pale hare. You can't quite see them, but you know your antlers, though small, are very valuable.

>x cage
You look around, desperate.

>x cage
As you inspect further, something catches your eye in the corner. Take a look!

>look
Awakening (in the cage)
You inspect the cage floor and gently sneeze, stirring up a clump of dust in the corner of the cage. It slips through the bars effortlessly. Unbelievable.

* * *

>look in corner
Oh! A loose bar catches your eye, sticking out admist the darkness. Can you destroy it with something?

>butt loose bar with antlers
You ram your antlers into the loose loose bar, and it shatters into shimmering shards. A hole you can slip through is now in its place. Wriggling your way through the hole, you quietly slink around the cage and look forward.
 
Darkened storage room
You now have a slightly better view of the room, and get a full idea of just how large the room is compared to you. Stacks of paper tower imposingly above. There are three sections of the room with items scattered about to the north, east, and west respectively.

Various boxes, small and large, are scattered about on the ground.

* * *

>x cage
As you inspect further, something catches your eye in the corner. Take a look!

>look at the cage
You look around, desperate.

>look at me
You can't quite see them, but you know your antlers, though small, will go for a pretty penny in due time.

>look in corner
Oh! A loose bar catches your eye, sticking out admist the darkness. Can you destroy it with something?

>destroy loose bar
(with )

You ram your antlers into the loose loose bar, and it shatters into shimmering shards. A hole you can slip through is now in its place. Wriggling your way through the hole, you quietly slink around the cage and look forward.
 
Darkened Storage Room
You now have a slightly better view of the room, and get a full idea of just how large the room is compared to you. Boxes and papers tower imposingly above. There are three sections of the room with items scattered about to the north, east, and west respectively.

>n
Plaques & Papers
To the north are stacks of metal chairs and wooden slabs, golden engravings nailed into each of them. Papers with incomprhensible scrawls are scattered all over the floor. Photographs of animals are attached to some of the papers

One metal chair has fallen from the stack and is on the floor.

If you squint, you can also see a vent on the wall. Could you somehow reach that?

>s
Darkened Storage Room
A heavy, constricting atmosphere surrounds you

>e
Cases & Calamity
To the east, empty glass display cases line the wall, one of which is smashed, possibly targeted in a robbery of some sort. You stop yourself just before stepping directly into a pile of glass shards. When was this place last cleaned?

* * *

>w
Darkened Storage Room
you feel uneasy and exposed.

>e
Cases & Calamity
To the east, empty glass display cases line the wall, one of which is smashed, possibly targeted in a robbery of some sort. You stop yourself just before stepping directly into a pile of glass shards. When was this place last cleaned?

* * *

>s
You can't go that way.

>w
Darkened Storage Room
A heavy, constricting atmosphere surrounds you

>s
You can't go that way.

* * *

>n
You can't go that way.

>e
Darkened Storage Room
you feel uneasy and exposed.

>n
Plaques & Papers
To the north are stacks of metal chairs and wooden slabs, golden engravings nailed into each of them. Papers with incomprhensible scrawls are scattered all over the floor. Photographs of animals are attached to some of the papers

One metal chair has fallen from the stack and is on the floor.

If you squint, you can also see a vent on the wall. Could you somehow reach that?

* * *

>x me
Squinting in the darkness, you observe yourself- a small, pale hare. You can't quite see them, but you know your antlers, though small, are very valuable.

>x loose bar
You wonder what lies outside of this barren, belittiling cage.

>x me
 one of the glimmering metal bars sits slightly askew. Maybe a hard hit could break it?  .

>x me
 The cage bars tower above you, the world all too large for someone your size.

>x loose bar
 You gently sneeze, stirring up a clump of dust in the corner of the cage. It slips through the bars effortlessly. Unbelievable.

* * *

>x me
Squinting in the darkness, you observe yourself- a small, pale hare. You can't quite see them, but you know your antlers, though small, are very valuable.

>x me
As you inspect further, something catches your eye in the corner.

>x me
 The cage bars tower above you, the world all too large for someone your size. 
...

>x me
 Your pelt is soft and fuzzy, though you cannot describe its color with the little light available. 
...

>x me
 ...Your antlers are solid and sturdy, possibly useful.

...

>x me
 Oh! you have small, white wings. 
.......

* * *

>x me
As you inspect further, something catches your eye in the corner.

>inspect corner
That's not a verb I recognise.

* * *

>x me
As you inspect further, something catches your eye in the corner.

>x
(the cage)
Despite your unfortunate predicament, you know there must be a way out.

* * *

>x me
As you inspect further, something catches your eye in the corner.

>x cage
The cage is dismal and dim, with nothig to note, unless.? Look closer.

>c age
That's not a verb I recognise.

>x cage
You inspect the cage floor and gently sneeze, stirring up a clump of dust in the corner of the cage. It slips through the bars effortlessly. Unbelievable.

>x cage
As you inspect, something catches your eye in the corner.

* * *

>x cage
The cage is dismal and dim, with nothig to note, unless.? Look closer.

>x cage
 You think back to a time before all of this, fearless. You were foolish then.

* * *

>x me
As you inspect further, something catches your eye in the corner.

>x me
...Your antlers are solid and sturdy, possibly useful to destroy something.

>bite
You bite and knaw, but get nothing but a hard mouthfull of hard metal. Ouch.

* * *

>x me
...Your antlers are solid and sturdy, possibly useful to destroy something.

>x me
Your head is that of a hare, yellow eyes wide like saucers. The cage bars tower above you, the world all too large for someone your size.

>xme
That's not a verb I recognise.

>x me
 ...Your antlers are solid and sturdy, possibly useful.

* * *

>x me
 Squinting in the darkness, you observe your small, pale wings.

>x antlers
You think more about your antlers. They're hard enough to leave a dent in something. But where?

* * *

>x me
Your head is that of a hare, yellow eyes wide like saucers. The cage bars tower above you, the world all too large for someone your size.

>x
(the cage)
Despite your unfortunate predicament, you know there must be a way out.

* * *

>x me
Your head is that of a hare, yellow eyes wide like saucers. The cage bars tower above you, the world all too large for someone your size.

>x cage
The cage is dismal and dim, with nothig to note, unless...? Look closer.

>x cage
You inspect the cage floor and gently sneeze, stirring up a clump of dust in the corner of the cage. It slips through the bars effortlessly. Unbelievable.

>x cage
As you inspect further, something catches your eye in the corner.

* * *

>x me
Your head is that of a hare, yellow eyes wide like saucers. The cage bars tower above you, the world all too large for someone your size.

>x me
Your pelt is soft and fuzzy, though you cannot describe its true color with the little light available.

>x loose bar
It's slightly askew and looks loose. Maybe a hard hit could break it?

* * *

>x me
Your pelt is soft and fuzzy, though you cannot describe its true color with the little light available.

>x me
Squinting in the darkness, you observe your small, pale wings.

>x
(the cage)
Despite your unfortunate predicament, you know there must be a way out.

* * *

>x
(the cage)
You wonder what lies outside of this barren, belittiling cage.

>x
(the cage)
 You gently sneeze, stirring up a clump of dust in the corner of the cage. It slips through the bars effortlessly. Unbelievable. 
...Something glitters in the corner.

>x
(the cage)
 You think back to a time before all of this, fearless. You were foolish then.

* * *

>x me
Squinting in the darkness, you observe your small, pale wings.

>x cage
You poke around the ground and gently sneeze, stirring up a clump of dust in the corner of the cage. It slips through the bars effortlessly. Unbelievable.

>x cage
 You think back to a time before all of this, fearless. You were foolish then.

* * *

>x cage
..Something catches your eye in the corner.

>look in corner
Oh! A loose bar catches your eye, sticking out admist the darkness. Can you destroy it with something?

>destroy loose bar with antlers
The loose bar shatters into shimmering shards, a hole you can slip through now in its place. Wriggling your way through the hole, you quietly slink around the cage and look forward.
 
 You wonder what lies outside of this barren, belittiling cage.

* * *

>x cage
..Something catches your eye in the corner.

>x cage
Despite your unfortunate predicament, you know there must be a way out.

.....

>x cage
 Isn't this getting old? 
.......

>x cage
 You gently sneeze, stirring up a clump of dust in the corner of the cage. It slips through the bars effortlessly. Unbelievable. 
...

>x cage
Despite your unfortunate predicament, you know there must be a way out.

...

>x cage
Despite your unfortunate predicament, you know there must be a way out.

.....

>x cage
 Isn't this getting old? 
...

>x cage
 Something clatters to the floor rooms ahead. 
.....

>x cage
Despite your unfortunate predicament, you know there must be a way out.

..

>x cage
 Isn't this getting old? 
.......

* * *

>x cage
 You gently sneeze, stirring up a clump of dust in the corner of the cage. It slips through the bars effortlessly. Unbelievable. 
...

>x cage
 You're more than this. But what part of you will be of use? Look closer. 
.......

>x cage
Despite your unfortunate predicament, you know there must be a way out.

..

>x cage
You wonder what lies outside of this barren, belittiling cage.

.......

>x cage
 You think back to a time before all of this, fearless. You were foolish then. 
.......

* * *

>x me
You can't quite see them, but you know your antlers, though small, will go for a pretty penny in due time.

>x cage
The cage is dismal and dim, with nothig to note, unless...? Look closer.

* * *

>x cage
As you inspect further, something catches your eye in the corner.

>x cage
The cage is dismal and dim, with nothig to note, unless...? Look closer.

* * *

>x cage
You inspect the cage floor and gently sneeze, stirring up a clump of dust in the corner of the cage. It slips through the bars effortlessly. Unbelievable.

>look in corner
Oh! A loose bar catches your eye, sticking out admist the darkness. Can you destroy it with something?

>destroy loose bar with antlers
The loose bar shatters into shimmering shards, a hole you can slip through now in its place. Wriggling your way through the hole, you quietly slink around the cage and look forward.
 
Darkened Storage Room

You now have a slightly better view of the room, and get a full idea of just how large the room is compared to you. Boxes and papers tower imposingly above... Tread lightly.

>x
(antlers)
As you inspect further, something catches your eye in the corner.

>x
(antlers)
The cage is dismal and dim, with nothig to note, unless...? Look closer.

>x
(antlers)
You inspect the cage floor and gently sneeze, stirring up a clump of dust in the corner of the cage. It slips through the bars effortlessly. Unbelievable.

>x
(antlers)
As you inspect further, something catches your eye in the corner.

* * *

>x
(antlers)
The cage is dismal and dim, with nothig to note, unless...? Look closer.

>x me
...Your antlers are solid and sturdy, possibly useful to destroy something.

* * *

>x me
You can't quite see them, but you know your antlers, though small, will go for a pretty penny in due time.

>x me
 The cage bars tower above you, the world all too large for someone your size.

>x me
 Your pelt is soft and fuzzy, though you cannot describe its color with the little light available. 
In the corner, a glimmer catches your eye. A loose bar?

>x me
 ...Your antlers are solid and sturdy, possibly useful.

...

* * *

>x me
 Your pelt is soft and fuzzy, though you cannot describe its color with the little light available. 
In the corner, a glimmer catches your eye. A loose bar?

>x me
 Your antlers, though small, will go for a pretty penny in due time.

>x me
 Oh! you have small, white wings.

>x me
 ...Your antlers are solid and sturdy, possibly useful.

>x cage
 You think back to a time before all of this, fearless. You were foolish then.

>x cage
You pace back and forth, contemplating.

>x cage
 You gently sneeze, stirring up a clump of dust in the corner of the cage. It slips through the bars effortlessly. Unbelievable.

>x cage
Despite your unfortunate predicament, you know there must be a way out.

* * *

>x me
 ...Your antlers are solid and sturdy, possibly useful.

>x me
 Oh! you have small, white wings.

>x me
 Your antlers, though small, will go for a pretty penny in due time.

>x me
 Your pelt is soft and fuzzy, though you cannot describe its color with the little light available.

>x me
 Your antlers, though small, will go for a pretty penny in due time.

* * *

>x me
 Oh! you have small, white wings.

>x me
 Oh! you have small, white wings.

* * *

>x me
Your head is that of a hare, yellow eyes wide like saucers. The cage bars tower above you, the world all too large for someone your size.

>x mee
You can't see any such thing.

>x me
Your pelt is soft and fuzzy, though you cannot describe its true color with the little light available.

>x me
Squinting in the darkness, you observe your small, pale wings.

...Something glitters in the corner.

* * *

>x me
...Your antlers are solid and sturdy, possibly useful to destroy something.

>x ne
Despite your unfortunate predicament, you know there must be a way out.

>x me
 Your pelt is soft and fuzzy, though you cannot describe its true color with the little light available.

* * *

>x me
Squinting in the darkness, you observe yourself- a small, pale hare. You can't quite see them, but you know your antlers, though small, are very valuable.

>x ne
Despite your unfortunate predicament, you know there must be a way out.

>x me
 Your antlers, though small, will go for a pretty penny in due time.

* * *

>x me
 The cage bars tower above you, the world all too large for someone your size.

>x me
 Your pelt is soft and fuzzy, though you cannot describe its color with the little light available.

>x me
 ...Your antlers are solid and sturdy, possibly useful.

* * *

>x me
Squinting in the darkness, you observe yourself- a small, pale hare. You can't quite see them, but you know your antlers, though small, are very valuable.

>x surrounding
You can't see any such thing.

>x cage
  You're more than this. But what part of you will be of use? Look closer. 
.......

* * *

>x me
Squinting in the darkness, you observe yourself- a small, pale hare. You can't quite see them, but you know your antlers, though small, are very valuable.

>x surroundings
You can't see any such thing.

* * *

The last thing you remember was your lush world flashing before your eyes.. how quickly times can change.

                                                                                                                                                                                                                                                                                                                               Press SPACE to begin.

>x player
You can't see any such thing.

>x self
 you are light .

>x self
 you are soft .

* * *

The last thing you remember was your lush world flashing before your eyes.. how quickly times can change.

                                                                                                                                                                                                                                                                                                                               Press SPACE to begin.

>x room
You can't see any such thing.

>x
()
The cage is dismal and dim, with nothig to note, unless...? Look closer.

>x
()
You inspect the cage floor and gently sneeze, stirring up a clump of dust in the corner of the cage. It slips through the bars effortlessly. Unbelievable.

>x cage
As you inspect further, something catches your eye in the corner.

* * *

>x room
You can't see any such thing.

>x awakening
You can't see any such thing.

>x room
You can't see any such thing.

* * *

The last thing you remember was your lush world flashing before your eyes.. how quickly times can change.

                                                                                                                                                                                                                                                                                                                               Press SPACE to begin.

>x self
 Oh! you have small, white wings.

>examine
(the cage)
You see nothing special about the cage.

>examine self
you are soft.

* * *

>x self
 Oh! you have small, white wings.

>x
What do you want to examine?

>x
What do you want to examine?

>cage
Despite your unfortunate predicament, you know there must be a way out.

>x self
 The cage bars tower above you, the world all too large for someone your size.

* * *

>x self
 Your antlers, though small, will go for a pretty penny in due time.

>open cage
That's already open.

>n
You would have to get out of the cage first.

* * *

>x self
 Oh! you have small, white wings.

>x selr
You can't see any such thing.

>x me
 The cage bars tower above you, the world all too large for  someone your size.

>x me
 Oh! you have small, white wings.

>x me
 .

>x me
 The cage bars tower above you, the world all too large for  someone your size.

>x me
 The cage bars tower above you, the world all too large for  someone your size.

>x loose bar
 You gently sneeze, stirring up a clump of dust in the corner of the cage. It slips through the bars effortlessly. Unbelievable.

>x bar
You pace back and forth, contemplating.