TestTwo
An Interactive Fiction by Ava Morgan
Release 1 / Serial number 250924 / Inform 7 v10.1.2 / D

Eyes Ahead
You'll need to be watching.

The sun slowly rises into the sky, the cool morning breeze enveloping you as you march along the silty dirt. In front of you is a great, roaring river, its depths murky and dark.

Legends say a great evil destroyed this beautiful ecosystem long ago by devouring all of its fish and aquatic life, and the ground itself feels unsteady as you approach...

...yet, in this singular, picturesque snpashot of time, the water, angry as it is, is inviting. Something calls to you from within..

..something, spiraling out from the river. You must proceed.

>enter
You must supply a noun.

>enter s
You must name something more substantial.

>s
Open your eyes

>why
That's not a verb I recognise.

* * *

>examine ground
A long rope lays in the dusty dirt.

>take rope
Taken.

>take harpoon
you lasso the harpoon with the rope.

>examine riv3er
You can't see any such thing.

>x river
You can't see any such thing.

>see river
That's not a verb I recognise.

>go to river
You can't see any such thing.

>examine river
You can't see any such thing.

>examine River
You can't see any such thing.

* * *

>go
You'll have to say which compass direction to go in.

>n
Forest
Lush green trees bust from the ground.

* * *

>l river
You can't see any such thing.

>l
The river has turned rough and angry and cannot be entered.

>l
The river has turned rough and angry and cannot be entered.

>x river
You can't see any such thing.

>x
(Harpoon)
Rust grows around its edges. It's plunged deep into the center of the river, the remains of a fierce battle.

* * *

>proceed
Open your eyes

>x ground
You can't see any such thing.

>see ground
That's not a verb I recognise.

>ground
That's not a verb I recognise.

>x
What do you want to examine?

>ground
You can't see any such thing.

>take rope
You can't see any such thing.

* * *

>s
Your eyes

>go south
You can't go that way.

>proceed
You can't go that way.

* * *

>take
(Harpoon)
The harpoon is too far out in the river to reach

>proceed
You must supply a noun.

* * *

>take rope
You can't see any such thing.

>x ground
A long rope lays in the dusty dirt.

>take rope
Taken.

* * *

>x
(Harpoon)
Rust grows around its edges. It's plunged deep into the center of the river, the remains of a fierce battle.

>x ground
A long rope lays in the dusty dirt.

* * *

>take rope
Taken.

>take harpoon
you lasso the harpoon with the rope

* * *

>x ground
A long rope lays in the dusty dirt.

>l
River
You walk along the silty dirt. Legends say a great evil destroyed this ecosystem by devouring all of the fish, and the ground itself trembles as you approach, yet, water laps calmly at the riverbank.

As you approach, you spy a long harpoon spiraling out from the river.

You can also see rope here.

* * *

>x ground
A long rope lays in the dusty dirt.

>look at ground
You can't see any such thing.

* * *

>x ground
A long rope lays in the dusty dirt.

>proceed
You must supply a noun.

* * *

>x ground
A long rope lays in the dusty dirt.

>take
What do you want to take?

>rope
Taken.

>proceed
Open your eyes

* * *

>x ground
A long rope lays in the dusty dirt.

>x rope
You can't see any such thing.

* * *

>x harpoon
Rust grows around its edges. It's plunged deep into the center of the river, the remains of a fierce battle.

>x Harpoon
You can't see any such thing.

>examine harpoon
You can't see any such thing.

>look at harpoon
You can't see any such thing.

* * *

>x harpoon
Rust grows around its edges. It's plunged deep into the center of the river, the remains of a fierce battle.

>x ground
You can't see any such thing.

* * *

>x river
The river has turned rough and angry and cannot be entered.

>l river
You can't see any such thing.

>x ground
A long rope lays in the dusty dirt.

* * *

>x river
The river has turned rough and angry and cannot be entered.

>x River
You can't see any such thing.